111111111111111111111111111111011000000*
**111000001**11*****1**11**1110**00011*0
*11100110000****000011100000110*11000000
00000***110S00**000000000000000000011000
000000011011000000000100000000010000000*
1001100000111100011*00001100110*00110020
**00000100111100111111000001111100000011
*****0001111111001111111**11110**00000**
**********111111111111111111111110000111
111**11**1**111000001**11**11111000*****
**00****00*11100110000****00**0000000000
000000000000000***1100***00**00011*00000
0000010011000000011000***0000011***00*00
111000****100110000000000000000000001***
***1001111**00000100110000002100011**111
1110011111*****0001111100001111111111111
11000011111111000011***0000**01110000111
00000111**00***10011**00000000*****00011
001100111*000000011000000100200000000000
11111000000110001100000000001100000*1100
*1100000001111100000110110001000*00***11
**0001100100**00**120000@01000***1000000
**1000001100000*********111000111**11000
1100000111************111111101111111111
1110000111111111111111100001110000000000
11001000111**11**11111000*****01*01*0*10
0000010000111***00110000000000*10**01*01
00000***00000***00000011*000001*01*1*01*
***00***0000**00000011***00*00*01*11*010
**00****000X000020110000001***000011***@
111**11**111****111100011**11101101*01*1
11111111111111**1111111111111101*0*101*0
