1111000011111111111111111111111111111111
00***100111**11*****1111111111111**11**1
000000011000****00000111111110**00****00
01100011000S00**000000000000000**00***00
11111000001100000000020000000000000***00
00**00**12111100011*01111111100000000000
00000*****111100111111111111111200000011
**********111110011111111111111110000111
11111111111000001111*1100000101100001111
00000111**1001100000100000011000000111**
001100111*00000000000011000000001100111*
11***00000011000111010000110001111100000
011000000000000000000000000000*110000000
000001100121**11**000011001100**00011001
00100000*******000000000000000**10000011
11000***************00001000001100000111
11110000111111111111011000000****0000**0
**111000001**11**1110**00011*0**00000000
*11100110000****00**0*110000000000010020
000001111100***00**000000110000000000011
000000011*00***00000010000000*1101100010
10011000**00000000000*001100200000@01000
11000001**11000000211100000011****111000
111000001111100001110**00000****11111110
**********011000000*0**0000***1100001111
1**11**1110**00011*000000000**11001***00
00****00**0*1100000002001000000110000000
0000000000000001100011000000X00011000110
1100100000010000000*01000110110000011111
****0001110*0011002000010@000021**00**00
1111001***1100000011000111*********00000
11111001110**00000**01111111************
