1111111111111111111111111111111111111111011000000**00000011011100001111111111111
111**11**11**11**11111****11**11111111110**00011*00*11000**011000100111**11**111
1100***111111***0011000**0000001111111100*1100000000000011*000001000001110000011
0000***000000***0000000000000000000000000000011000000110000000***000000000000000
000000**0000**000000*110000000020000000001000S000**00000001000***00***0100000000
11020000000000002011**0001100101111111100*0011002002001100*000****00**0000110011
1111****1111****1111**100000111111111111110000001111000000111**11**1111100000111
1111**11111111**1111110001111111111111110**00000****00000**011111111111111**1111
1111111111111111111111000011111111111111*000000110111000011111111111111111111111
**11****11*****11**111001***0011****11**0*11000**01100100011**11****11111**11**1
00000**0000000****000110000000000**0000000000011*0000001000000000**000**00****00
00000000000000**000000110001100000000000000110000000000***0000000000000**00***00
000000011*00000000110000011111*110000000*000000010***00***00000000011*00000***00
10011000***11000111121**00**00**0001100102001100*0**00****0010011000**0000000000
11000001**1111001111*****00000**100000111100000011111**11**111000001**1200000011
11111000111110011111**********1100011111**00000**0111111111111111000111110000111
0000000***1110000111111111111111000011111110000111111111111111110000111111000011
0**000000*11000100111111111111110011110011000*****111**11**10011110011**11100000
000000**0000001000000111111110001000000000000000001100***1110000000100*111001100
000**0000*00***00000000000000000010001100011*000000000***00001100010000000011111
000000000000***00***0000000020000001****11***00*00000000**00****100000000000011*
0***001*0000****00**0111111110****0011000000001***1102000000001100****10011000**
00000000001**11**1111111111111*****0000000011**1111111****1100000*****11000001**
000000000011111111111111111111**********11111111111111**1111**********1110000011
11111111110**00000000000000**00**0000000111111111111111111110000000**0***0000**0
111**11**1000000**0000**000000000000**00**111000001**11**11100**000000**00000000
**00****00**0011100000011100****00111000*11100110000****00**00011100**0000000020
0**00***0000000000000000000000000000000000000***1100***00**000000000000000000011
00000***00010000000000000000100100000000000000011000***0000000000000101100100010
00000000000000110011110011000000001100111001100000000000000011001100000000001010
1200000011110000011111100000111100000111**0000010011000000211110000011****111000
11100001111111**11111111**11111111**1111*****0001111100001111111**1111**11111110
1110000111011000000*1111111111*0000001101111000011***0000**0***0000**01111111111
*****000110**00011*000000111**0*11000**00011110011**00000000**000000001111111111
00000000000*11000000001100111*00000011*00000000100000000002000000000200111111110
00000*1100000001100011***0000000011000000110001000000000001100000000110000000000
00*00***11010000000*0110000000*000000010****100000110010001011001000100000000020
***10000000*00110020000001100102001100*0001100****000000101000000010100111111110
111**11000110000001100100000**110000001100000*********111000****1110001111111111
11111111110**00000**11000*******00000**0************11111110**111111101111111111
1111111111111000011111110000110**0000****000000110111111111111111111110**0000000
1111111111*****0001100***1001100000000**0*11000**01**11*****1**11*****000000**00
011111111000000000000000000110020000000000000011*000****000000****0000**00111000
000000000000000*11000110001100110000000000011000000000**00000000**00000000000000
000000002000*00***1111111000000100010011*000000010110000000011000000000100000000
0111111110***100000000**00**12010100000002001100*0111100011*111100011*0000110011
1111111111111**1100000000*****000111****1100000011111100111111110011111100000111
11111111111111111111**********01111111****00000**0111110011111111001111111**1111
1111000011***00000001111111111**********1110000111111100001111111111111111111111
0011110011*000000**0**111000001**11**111*****0001100***10011**1110000000000111**
000000010000**000000*11100110000****00**00000000000000000110*111001100001100111*
0110001000*0000**00000000***11000000000000000*1100011000110000000***1111***00000
****10000000000000000000000110110010000000*00***11111110000000000001100110000000
001100****00*100***01001100000****000111***100000000**00**1210011000000000011001
00000*****0000000000**000001001111001***111**1100000000*******0000010000100000**
**********0000000000*****0001111111001111111111111***************0001111000*****
1111111111***00000001111111111***0000**00000000**011111111111111000011**********
*****11**1*000000**01**11**111**0000000000**000000111**11**10011110011111**11**1
0000****0000**000000111***0011000000002000011100**1100***1110000000100**00****00
0000**0000*0000**000000***0000000000001100000000000000***00001100010000000000000
0000000011000000000000**00000011001000100000000010000000**00****1000000000010011
*11000111100*100***000000020110000001010110011000011020000X0001100****111000****
1111001111000000000011****1111****11100011100000111111****1100000********1001111
111001111100000000001111**1111**111111101111**11111111**1111**********1110011111
