1111111111111111111111000011111111000011
1**11**1111**11**11100000111****11110011
00****00**00****00**001100111****0000111
00***00***00***00***1111100000*110001111
00***0000000***00000*1100000001111100000
00000000000S00000000**00011001001100111*
11000000211100000021**1000001100000111**
1110000111111000011111000111111111111111
1110000111111111111111111111111111111111
11000100111**11**11111***11***1**11**111
000010000000****00**1***11****00****00**
00***0000000***00***1**1111***00***00***
00***00***00***0000011***1111100***00000
00****00**0000000000111***11**0000000000
1**11**111110000002111***111**1100000021
11111111111110000111111***11111110000111
1111000011111000011111111111111111111111
**1111001111000100111**11**1111**11**111
***00001110000100000111***001100****00**
*11000111100***00000000***000000***00***
111110000000***00***00**00000000***00000
001100111*00****00**00000020110000000000
00000111**1**11**11111****11111100000021
111111111111111111111111**11111110000111
111111111111111111110**00000001110000111
00000111**1100011000000000**001100010011
001100111*1000110000**001110000000100000
11111000001001100000000000000000***00000
*110000000110000011101000X000000***00***
**0001100111100011**000011001100****00**
**1000001111000111**11000001111**11**111
1100011111111***11111111**11111111111111
