0**0000000111111111111111111111111111111
000000**001**11**1111**11**1111**11**111
**0011100000****00**00****00**00****00**
000000000000***00***00***00***00***00***
010000000000***0000000***0000000***00000
000011001100000000000S000000000000000000
1100000111110000002111000000211100000021
1111**1111111000011111100001111110000111
1111111111111111111111100001111111000011
1**11**1111**11**1111100010011**11110011
111000001100****00**0000100000***0000111
000000000000***00***00***00000*110001111
010000000000***0000000***00***1111100000
0000110011000000000000****00**001100111*
110000011111000000211**11**11100000111**
1111**1111111000011111111111111111111111
1111000011111000011111111111111111000011
**1111001111000100111**11**111**11110011
***0000111000010000000****00*****0000111
*11000111100***0000000***00****110001111
111110000000***00***00***000001111100000
001100111*00****00**0000000000001100111*
00000111**1**11**111110000002100000111**
1111111111111111111111100001111111111111
1111111111111111111111100001111110000111
1**11**1111**11**11111000100111100010011
00****00**111***001100001000000000100000
00***00***000***000000***0000000***00000
00***0000000**00000000***00***00***00***
00000000000X0000201100****00**00****00**
110000002111****11111**11**1111**11**111
11100001111111**111111111111111111111111
