1111111111111111111111111111111110000111
1**11**11100000111**1**11**1111100010011
00****00**001100111*00****00**0000100000
00***00***111110000000***00***00***00000
00***00000*11000000000***0000000***00***
0S00000000**00011001000000000000****00**
1100000021**1000001111000000211**11**111
1110000111110001111111100001111111111111
1110000111111100001111000011111111111111
1100010011**1111001100000111**11***11***
0000100000***0000111001100111*1***11****
00***00000*11000111111111000001**1111***
00***00***1111100000*11000000011***11111
00****00**001100111***00011001111***11**
1**11**11100000111****1000001111***111**
111111111111111111111100011111111***1111
1110000111111100001111000011111111111111
1100010011**1111001100000111**1**11**111
0000100000***0000111001100111*00****00**
00***00000*110001111111110000000***00***
00***00***1111100000*11000000000***00000
00****00**001100111***000110010000000000
1**11**11100000111****100000111100000021
1111111111111111111111000111111110000111
1100001111111111111111100001111111111111
00000111**1**11**111110001001100000111**
001100111*111***00110000100000001100111*
1111100000000***000000***000001111100000
*11000000000**00000000***00****110000000
**000110010X0000201100****00****00011001
**1000001111****11111**11**111**10000011
11000111111111**111111111111111100011111
