1100001111111000011111111111111111111111
0000011110110001001110011211111111110111
0011001110000010000000001000210001000001
1111100000000000000000210000210012100000
0110000000000000021100001000000000000000
000001100100000!001100000000000S00000000
@110000011100111111111000000211100000021
1100011111111111111111100001111110000111
1111111111111111111111000011111110000111
1100011000000001111200000111211100010011
1000110000001100111000110011100000100000
1001100000111110000011111000000012100000
1100000111111000000001100000000010000@10
1110001100000001100100000110010010000012
110001111010100000110!100000111001100111
1111001111110001111111000111111111111111
1110000111111100001111000011111111111111
1100010011121111001100000111001211111111
0000100000011000011100110011111111100011
0000000000011000111111111000000001100000
0021000002111110000001100000000000000000
0000000002001100111000000110010000002011
1001121111000001110101100000111101!01111
1111111111111111111111000111111111101111
1110000111111111111111111111111110000111
110001001100000111!000000111001100010011
0000100000001100111000110011120000100000
0010000000111110000011111000000000100000
00012000111110000000211000X0000000000001
000000000110000110010!000110010010000000
1101102111111000001110100000111011121111
1111111111110001111111000111111111111111
