1111111111111111111111111111111111111111
101110!11100000111001101121111100110!111
1110210011001100111000111100000002110001
0000100000111110000000010000000000000002
00010000000110000000002100000000@1000000
000000201100000110010S000000000000000000
1100001111001000001111000000211100000021
1111001111110001111111100001111110000111
1111111111111111111111111111111110000111
1021111111110111011110011001111100010011
0010110000111101001111101200110000100000
002110010000021@000000010000000000000000
0000000000001100000000010000000021000002
0000000000000000201100000020110000010020
1100000021110010111111002111111021101111
1110000111111110111111111011111111111111
1100001111111100001111111111111111111111
0000011112111111001100000111001100011000
0011001110000000011100110011111000110000
1111100000011000111111111000001001100000
2110000000111110000001100000001100000111
1000011001001100111110000110011110001102
2010000011000001111111100000111100011111
1100011111111111111111000111111110211111
1111111111111111111111110000111100001111
0000011100110001100021111100110000011100
001100111110001100000010000111001100111!
1111100000100110000021100011111111100000
011000X000110000011111111000000110000000
0000011001111000111100110011121200011001
2110000011110001110000000111100010000011
1100011111111011111111111111111100011111
