1,1,0,1,163,20,1,0,0,0,1,0,0,0,0,1
1,1,0,1,146,18,1,0,0,0,1,0,0,0,0,1
1,1,1,1,190,6,1,0,0,0,1,1,0,1,1,1
1,1,1,1,146,49,1,1,0,0,1,1,0,1,1,1
1,1,1,1,163,52,1,2,1,1,1,1,0,1,1,1
1,1,0,1,146,47,1,2,1,1,1,1,0,1,1,1
1,1,0,1,190,6,1,0,1,0,1,1,0,1,1,1
1,1,0,1,146,18,1,0,0,0,1,0,0,0,0,1
