0,0,1,0,52,16,0,2,1,1,0,1,0,1,1,0
0,0,1,0,47,17,0,1,0,0,0,1,0,1,1,0
0,0,0,0,6,62,0,0,0,0,0,0,1,0,0,0
0,0,0,0,18,14,0,0,0,0,0,0,1,0,0,0
0,0,0,0,20,16,0,0,0,0,0,0,1,0,0,0
0,0,0,0,18,17,0,0,0,0,0,0,0,0,0,0
0,0,0,0,6,62,0,1,0,1,0,0,0,0,0,0
0,0,0,0,49,14,0,2,1,1,0,1,0,1,1,0
