1111111111111111111111111111111111111111
1**11**11100000111**1**11**1111**11**111
111***0011001100111*00****00**00****00**
000***0000111110000000***00***00***00***
00**000000*11000000000***0000000***00000
0000002011**000110010S000000000000000000
11****1111**1000001111000000211100000021
1111**1111110001111111100001111110000111
1111111111111111111111111111111110000111
1**11**1111**11**1111**11**1111100010011
00****00**111***0011111***00110000100000
00***00***000***0000000***000000***00000
00***0000000**00000000**00000000***00***
00000000000000002011000000201100****00**
110000002111****111111****11111**11**111
11100001111111**11111111**11111111111111
1100001111111100001111111111111111111111
00000111****1111001100000111**1100011000
001100111****0000111001100111*1000110000
1111100000*11000111111111000001001100000
*1100000001111100000*1100000001100000111
**00011001001100111***0001100111100011**
**1000001100000111****1000001111000111**
110001111111111111111100011111111***1111
1111111111111111111111110000111100001111
00000111**1100011000**1111001100000111**
001100111*1000110000***0000111001100111*
11111000001001100000*1100011111111100000
*11000X00011000001111111100000*110000000
**0001100111100011**001100111***00011001
**1000001111000111**00000111****10000011
1100011111111***111111111111111100011111
