1111111111111111111111111111111111111111
11111!0111100110111110011211111100011000
0000100011001010001000100200211000110000
0000100011001000010100101000001001100000
0021000000000110000000000000001100000111
0S00000000000000000000000000001110001102
1100000021110000002111000000211100011101
1110000111111000011111100001111110111111
1111111111111000011111111111111111111111
0000011100110001001110211021111001121111
0011001112000010000000000100211110100011
111110000000@000000000012001100001010000
1110000000001110021200100000000001000000
0000011001000001001000000000000000002011
0110000011121111011111000000211101001111
1100011111111111111111100001111111101111
1110000111111111111111100001111111111111
1100010011112110111111000100111001110111
0000100000000101001000001000000000000021
0000000000000200011100021000000000000010
00012000000011100000000000000@0002100000
0010000011000000000000002100100000000000
1011102111110000002111111101111100000021
1111111111111000011111111111111110000111
1111000011111000011111111111111111111111
1011110011110001001112111011111111100111
0110000111000010000011101000111110010011
0110001111000210000000010100000001100000
1111100000000010000000100000000010000000
0011001112000110001000000020110X00002011
00000111111001100111112111111111@0001111
1111111111111111111111110111111111211111
