1111111111111111111111110000111111000011
121110011110!110011100111100110011110011
1111000011001110000100200001111000000111
0000100000000000000101100011110110001111
0000000000000100000011111000001111100000
00000020110S0000000000110011110011001110
1110001111110000002100000111@000000111!1
1111101111111000011111111111111111111111
1110000111111000011111111111111111111111
1100010011110001001112111111111211111111
0000100000000010000000010@00121111000011
0000100000000000000000000000000000110000
000@00000!00@110001000002000000010000000
0012110010001010000100000000000000002011
1101110111111111011111000000211100001111
1111111111111111111111100001111111101111
1111000011111111111111100001111111111111
1011110011111111111111000100110000011100
1000000111000002000000001000000011001110
1110001111000110000200000000001111100000
111110000000@110000000121002102110000000
0011001110000000000000111000112100011001
00000111@0110000002111011001110010000011
1111111111111000011111111111111100011111
1111111111111000011111111111111111111111
1211111111110001001110211021111011102111
11100000110000100000111@2100111111210011
0000000000000!00000000010100000000010000
010000000000102002100010000000001@000000
0000110011001010002100000020110X00002011
1100000111102111011111002111111110101111
1111001111111111111111110011111111011111
