1111111111111111111111110000111111000011
1**11**1111**11**111**11110011**11110011
111***001100****00*****0000111***0000111
000***000000***00****110001111*110001111
00**00000000***0000011111000001111100000
00000020110S00000000001100111*001100111*
11****1111110000002100000111**00000111**
1111**1111111000011111111111111111111111
1110000111111000011111111111111111111111
110001001111000100111**11**1111**11**111
0000100000000010000000****00**111***0011
00***0000000***0000000***00***000***0000
00***00***00***00***00***0000000**000000
00****00**00****00**00000000000000002011
1**11**1111**11**111110000002111****1111
1111111111111111111111100001111111**1111
1111000011111111111111100001111111111111
**111100111**11**111110001001100000111**
***000011100****00**0000100000001100111*
*11000111100***00***00***000001111100000
111110000000***0000000***00****110000000
001100111*000000000000****00****00011001
00000111**11000000211**11**111**10000011
1111111111111000011111111111111100011111
1111111111111000011111111111111111111111
1**11**11111000100111**11**1111**11**111
11100000110000100000111***0011111***0011
000000000000***00000000***0000000***0000
010000000000***00***00**00000000**000000
000011001100****00**00000020110X00002011
11000001111**11**11111****111111****1111
1111**111111111111111111**11111111**1111
