11111111111111111111111111111111111111110110000000000000011011100001111111111111
11100111111111101111110001111111111111110100001100011100001011000100111111100111
11001111111110010011000110000001111111100011000000000000111000001000001110000011
00000110000000100000000000000000000000000000011000000110000000000000000000000000
000000000000000000001110000000020000000001000S0000000000001000010000010100000000
11020000000000002011110001100101111111100000110020020011000000001100100000110011
11110101111110111111011000001111111111111100000011110000001111011001111100000111
11110011111111001111110001111111111111110010000011110000000011111111111111101111
11111111111111111111110000111111111111111000000110111000011111111111111111111111
00111010111111011101110010000011000011010111000010110010001101110011111111111001
00000110000000000000011000000000011000000000001100000001000000000000001100000000
00000000000000100000001100011000000000000001100000000000000000000000000110010100
00000001110000000011000001111101100000001000000010010001100000000001110000010000
10011000100110001111210100000001000110010200110010000001010010011000100000000000
11000001101111001111000110000011100000111100000011111001100111000001001200000011
11111000111110011111001001100111000111110100000010111111111111111000111110000111
00000001001110000111111111111111000011111110000111111111111111110000111111000011
01100000001100010011111111111111001111001100011110111011110100111100110011100000
00000011000000100000011111111000100000000000000000110010011100000001001111001100
00011000010012100000000000000000010001100011100000000001100001100010000000011111
00000000000000200000000000002000000111011110100100000000000001111000000000000110
00100011000000110010011111111000100011000000001100110200000000110000011001100000
00000000001001110111111111111101010000000001110111111110111100000111101100000110
00000000001111111111111111111100101100111111111111111110111110111011011110000011
11111111110000000000000000010001000000001111111111111111111100000001100110000000
11101111110000000100001000000000000002001011100000111111111100000000001000000000
00000010000000111000000111000011001110001111001100001100000000011100100000000020
00100010000000000000000000000000000000000000000111000100000000000000000000000011
00000000000100000000000000001001000000000000000110000110000000000000101100100010
00000000000000110011110011000000001100111001100000000000000011001100000000001010
12000000111100000111111000001111000001111100000100110000002111100000111101111000
11100001111111001111111100111111110011110000100011111000011111111011110011111110
11100001110110000001111111111110000001101111000011000000010011100000001111111111
01100000110100001110000001110100110001000011110011000000000010000000001111111111
00000000000011000000001100111100000011100000000100000000002000000000200111111110
00000111000000011000110110000000011000000110001000000000001100000000110000000000
00100111110100000001011000000000000000100001100000110010001011001000100000000020
01010000000000110020000001100102001100100011000101000000101000000010100111111110
1110011000110000001100100000011100000011000001001110!011100010111110001111111111
11111111110010000011110000011101000001100110001000001111111001111111101111111111
11111111111110000111111100001101100001110000000110111111111111111111110010000000
11111111110110100011001111001100000000010111000110101110110111111100100000001000
01111111100000000000000000011002000000000000001100000110000000000100001000111000
00000000000000001100011000110011000000000001100000000010000000000000000000000000
00000000200000000011111110000001000100110000000010110000000011000000000100000000
01111111100001000000001100111201010000000200110010111100011111110001110000110011
11111111111111011000000000110000011100001100000011111100111111110011111100000111
11111111111111111111010010101101111111001100000000111110011111111001111111101111
11110000110010000000111111111101001011101110000111111100001111111111111111111111
00111100110000000010101110000010111111110011100011000011001110111000000000011101
00000001000010000000111100110000111100100000000000000000011001110011000011001111
0110001000100001100000000@001100000000000000001100011000110000000101111101100000
10011000000000000000000000011011001000000000000111111110000000000001100110000000
00110001000011001110100110000001010001110101000000000100011210011000000000011001
00000011110000000000110000010011110010001111011000000000110000000001000010000001
00100111000000000000101010001111111001111111111111110100101111001000111100001111
11111111110010000000111111111101100001000000000110111111111111110000110110011011
00011111010000000010101111111100000000000011000000111101100100111100111110011111
00000111000010000000111100001100000000200001110011110011011100000001001100021000
00000000001000011000000101000000000000110000000000000010000001100010000000000000
00000000110000000000000!00000011001000100000000010000000100011101000000000010011
0110001111000100010000000020110000001010110011000011020000X000110011101110000010
11110011110000000000111100111100001110001110000011111100011100000001000111001111
11100111110000000000111111111110111111101111001111111110111110011000011110011111
