1111111111111111111111111111110110000000
0011100000111111100010011101110100001110
1111001100000010000011100000110111000000
00000011110S0001000000000000000000011000
0000000110110000000001000000000100000000
1001100000111100011000001100110100110020
1000000100111100111111000001111100000011
1001100011111110011111110011110110000011
0000011001111111111111111111111110000111
1110011111101110000010111001111100010001
1000000100111100110000111000000000000000
0000000000000000001100111000100011000000
0000010011000000011000001000001101000100
1110001000100110000000000000000000001100
1101001111010000010011000000210001101111
1110011111110110001111100001111111111111
1100001111111100001101100000001110000111
0000011110000101001100000000000001100011
0011001111000000011000000100200000000000
1111100000011000110000000000110000011100
0110000000111110000011011000100010011011
010001100100000001120000@010001101000000
1010000011000001100001111110001111111000
1100000111111001110110111111101111111111
1110000111111111111111100001110000000000
1100100011110110011111000011000100100010
0000010000111010001100000000000100001101
0000001000000101000000110000001001010011
1000000100000000000011111001000011110010
00000100000X000020110000001010000011011@
1111011001110011111100011211110110100101
1111111111111100111111111111110110010110
