1111000011111111111111111111111111111111
0011110011110111100011111111111111011001
0000000110001110000001111111101000010100
01100011000S0011000000000000000100010000
1111100000110000000002000000000000010000
0010000012111100011001111111100000000000
0000000010111100111111111111111200000011
1000110001111110011111111111111110000111
1111111111100000111111100000101100001111
0000011100100110000010000001100000011100
0011001110000000000000110000000011001111
1110000000011000111010000110001111100000
0110000000000000000000000000001110000000
0000011001211111000000110011000000011001
0010000001001010000000000000000110000011
1100001000011111000000001000001100000111
1111000011111111111101100000010000000110
0111100000101110111100100011001100000000
1111001100000101000001110000000000010020
0000011111000110001000000110000000000011
0000000110001100000001000000001101100010
1001100001000000000000001100200000@01000
1100000100110000002111000000110010111000
1110000011111000011100100000010111111110
0110010110011000000100000001101100001111
1011101111011000110000000000101100111000
0010100000011100000002001000000110000000
0000000000000001100011000000X00011000110
1100100000010000000001000110110000011111
1110000111000011002000010@00002101002100
1111001101110000001100011111111000000000
1111100111010000001101111111000010110000
