1111111111111111111111000011111111111111
1101101111121110011100000111001011100111
1111000011111000001100110011120011210012
0002100000000000000011111000000021000010
0010000000010000000021100000000011100000
0000002011000011001101000110010S00000000
1102101111110000011100100000111100000021
1111111111111121111111000111111110000111
1111111111111111111111000011111100001111
101110211111101110@000000111110000011112
0000210000110111010100110011100011001110
000020021010011110@111111000001111100000
0021100000112101111111100000001110000000
0000000000111200110001000110011100011001
1100000021110211110021100000110010000011
1110000111111000111111000111111100011111
1110000111111100001111111111111110000111
1100010011211111001110011001111100010011
00001000000@000001110000@000020000100000
0002100000111000111100210000100000000000
0000200000111110000000101000000000000020
00101@0000001100111000000000000000010010
1001111111000001110011000000211011110111
1111111111111111111111100001111111111111
1110000111111000011111111111111111111111
1100010011110001001100000111001111100111
0000100000000010000000110011100000000000
0001200000000000000011111000000002100000
00001001020021000021211000X0000010000000
0021010001000010000001000110010000000000
11111211111001111111@1100000111100000021
1111111111111111111111000111111110000111
