1111111111111111111111111111111111111111
1001100111101111011110011!0111000001110!
0011000002000100000000021000000011001111
000010000@00001000210000@000211111100000
0010000000000000000000111000001110000000
00000000000S0000000000000000000000011001
1100000021110000002111000000212110000011
1110000111111000011111100001111100011111
1110000111111111111111000011111111111111
1100010011102112111100000111021100011000
0000100000000000000!00110011111000110000
000@200000000000001011111000001001100000
0011100000000000000001100000001100000111
0010000000000000000011000110011110001121
1101110111110000002111100000111100011100
1111111111111000011111000111111112101111
1111111111110000111111111111111111111111
1100011000000001110000000111001100011000
1000110000001100111000110011101000110000
1001100000111110000011111000001001100000
1100000111011000000001100000001100000111
1110001121210001100121000110011110001120
1100011101001000001100100000111100011101
1112101111110001111111000111111111001111
1110000111111111111111111111111110000111
1100010011000001112100000111111100010011
0000100000001100111000110011110000100000
0021100000111110000011111000000002100000
0001000000111000X00021100000000012100000
000111000010000110010!00011001000111000!
1101100111011000001111100000111101101111
1111111111110001111111000111111111111111
