1111111111111111111111111111111111111111
00000111**1**11**1111**11**1111**11**111
001100111*111000001100****00**00****00**
1111100000000000000000***00***00***00***
*110000000010000000000***0000000***00000
**0001100100001100110S000000000000000000
**10000011110000011111000000211100000021
11000111111111**111111100001111110000111
1100001111111000011111111111111110000111
00000111**11000100111**11**1111100010011
001100111*000010000000****00**0000100000
111110000000***0000000***00***00***00000
*11000000000***00***00***0000000***00***
**0001100100****00**000000000000****00**
**100000111**11**11111000000211**11**111
1100011111111111111111100001111111111111
1111111111111111111111100001111111111111
1**11**11100000111**11000100111**11**111
00****00**001100111*000010000000****00**
00***00***111110000000***0000000***00***
00***00000*11000000000***00***00***00000
0000000000**0001100100****00**0000000000
1100000021**100000111**11**1111100000021
1110000111110001111111111111111110000111
0**0000000111111111111111111111110000111
000000**0011***11***1**11**1111100010011
**001110001***11****11100000110000100000
00000000001**1111***000000000000***00000
010000000011***11111010000000X00***00***
0000110011111***11**000011001100****00**
110000011111***111**11000001111**11**111
1111**1111111***11111111**11111111111111
