1111111111111111111111111111111111111111
1001121111000001110111011001111111102111
0010000011001100111100100100000010010021
001020010011111000000010100@100021000102
0000000000011000000000111000000002100000
000000000002000110010S000000000000000000
1100000021101000001111000000211100000021
1110000111110001111111100001111110000111
1100001111111100001100100000001110000111
00000111@1@01111001100000021001100010011
0011001111010000011101001110000000100000
1111100000011000111100000000000010000000
011000000011111000000100000000001010021@
0200011001001100111100001100110001010011
2010000011000001110111000001111001101111
1100011111111111111111110011111111111111
1100001111111100001111100001111111111111
0000011101211111001111000100110000011111
0011001110000000011100001000000011001110
1111100000011000111100021000001111100000
0110000000111110000000021001102110000000
1000011001001100111000002100111100011001
0110000011000001110110011101111110000011
1100011111111111111111111111111100011111
1110000111001000000011100001111110000111
1100010011000000020011000100111100010011
0000100000000011100000001000000000100000
0010000000000000000000000000000021100000
002110002101000X000000211000000001000000
0000110000000011001100101100000000000012
10@1111111110000011110011011111211121111
1111111111111110111111111111111111111111
