1100001111111000011111111111111111111111
00000111**11000100111**11**1111**11**111
001100111*000010000000****00**00****00**
111110000000***0000000***00***00***00***
*11000000000***00***00***0000000***00000
**0001100100****00**00000000000S00000000
**100000111**11**11111000000211100000021
1100011111111111111111100001111110000111
1111111111111111111111000011111110000111
110001100000000111**00000111**1100010011
1000110000001100111*001100111*0000100000
10011000001111100000111110000000***00000
1100000111*110000000*11000000000***00***
11100011****00011001**0001100100****00**
11000111****10000011**100000111**11**111
111***1111110001111111000111111111111111
1110000111111100001111000011111111111111
1100010011**1111001100000111**1**11**111
0000100000***0000111001100111*111***0011
00***00000*1100011111111100000000***0000
00***00***1111100000*11000000000**000000
00****00**001100111***000110010000002011
1**11**11100000111****1000001111****1111
1111111111111111111111000111111111**1111
1110000111111111111111111111111110000111
110001001100000111**00000111**1100010011
0000100000001100111*001100111*0000100000
00***000001111100000111110000000***00000
00***00****110000000*11000X00000***00***
00****00****00011001**0001100100****00**
1**11**111**10000011**100000111**11**111
1111111111110001111111000111111111111111
