1111111111111111111111110000111111000011
1**11**1111**11**111**11110011**11110011
00****00**00****00*****0000100***0000110
00***00***00***00****110000000*110001100
00***0000000***0000011111000001111100000
0S000000000000000000001100111*001100111*
1100000021110000002100000111**00000111**
1110000111111000011111111111111111111111
***0000000111111111111111111111111111111
*000000**011***11***1**11**1111100011000
00**0000001***11****00****00**100@110000
*0000**0001**1111***00000000001001100000
000000000011***1111111001000001100000111
00**00***0111***11**111100011111100011**
000000000011***111**111100111111000111**
0000000000111***11111111100111111***1111
***0000000***00000001110000111***0000000
*000000**0*000000**01100010011*000000**0
00**00000000**000000000010000000**000000
*0000**000*0000**00000***00000*0000**000
0000000000000000000000***00***0000000000
00**00***000**00***000****00**00**00***0
000000000000000000001**11**1110000000000
000000000000000000001111111111****100***
***0000**0111000011111111111111110000111
**00000000110001111111111111111100010011
0000000020000000000001111111100000100000
0X000000110011*00000000000000000***00000
110010001111***00*00000000002000***00***
000000101111****0***011111111000****00**
****1110001**11**11111111111111**11**111
**11111111111111111111111111111111111111
