111100001111111111111111111111***0000000
**111100111**11**1111**11**111*000000**0
***000011100****00**00****00**0000000000
*11000111100***00***00***00****0000**000
111110000000***0000000***000000000000000
001100111*00000000000S0000000000**000000
00000111**110000002111000000210000000000
1111111111111000011111100001110000000***
1100001111111000011111111111111111111111
00000111**11000100111**11**1111**11**111
001100111*000010000000****00**00****00**
111110000000***0000000***00***00***00***
*11000000000***00***00***0000000***00000
**0001100100****00**00000000000000000000
**100000111**11**11111000000211100000021
1100011111111111111111100001111110000111
0**0000000111111111111000011111111000011
000000**0000000111**00000111****11110011
**00111000001100111*001100111****0000111
000000000011111000001111100000*110001111
0100000000*110000000*1100000001111100000
0000110011**00011001**00011001001100111*
1100000111**10000011**1000001100000111**
1111**1111110001111111000111111111111111
1100001111111111111111100001110**0000000
00000111**1**11**1111100010011000000**00
001100111*111***00110000100000**00111000
1111100000000***000000***000000000000000
*11000000000**00000000***00***01000X0000
**00011001000000201100****00**0000110011
**1000001111****11111**11**1111100000111
11000111111111**111111111111111111**1111
