11111111111111000011110000111111111111111111111111011000000*
00000111****1111001100000111**00000111**1**11**111***00011*0
001100111****0000111001100111*001100111*00****00**0*11000000
1111100000*110001111111110000011111000000S000000000000011000
*1100000001111100000*110000000*1100000001100100000110000000*
**00011001001100111***00011001**0001100111110001110*00110020
**1000001100000111****10000011**1000001111110011111100000011
110001111111111111111100011111110001111111111001110**00000**
***0000**0***0000**01111111111111111111111111111111110000111
**00000000**000000001**11**1111**11**1111**11**1111100010011
00000000200000000020111***001100****00**11100000110000100000
00000000110000000011000***00000000000000000000000000***00000
1100100111110010011100**0000001100100000010000000000***00***
0000001111000000111100000020111111000111000011001100****00**
****111111****11111111****1111111100111111000001111**11**111
**11111111**111111111111**111111111001111111**11111111111111
1111000011***0000**01111111111***00000001111111111011000000*
**11110011**000000001**11**111*000000**011000011*****00011*0
***0000111000000002000****00**00**000000000000001*0*11000000
*110001111000000001100***00****0000**00000000000000000011000
1111100000110010011100***000000000000000*110000000110000000*
001100111*0000001111000000000000**00***0**000110010*00110020
00000111******11111111000000210000000000**100000111100000011
1111111111**111111111110000111****111***11000111110**00000**
1111000011011000000****0000000***0000**011110000111100001111
**11110011***00011*0*000000**0**00000000**1111001100000111**
***00001110*1100000000**0000000000000020***0000111001100111*
*1100011110000011000*0000**0000000000011*1100011111111100000
1111100000110000000*000000000011001001111111100000*110000000
001100111*0*0011002000**00***00000001111001100111***00011001
00000111**11000000110000000000****11111100000111****10000011
11111111110**00000******111*****1111111111111111111100011111
**********1111111111***0000000111000011111111111111100001111
1**11**1111100011000*000000**011000100111**11**11100000111**
00****00**100@11000000**000000000010000000****00**001100111*
00000000111001100000*0000**00000***0000000000000001111100000
1100100***1100000111000000000000***00***1100100000*110000000
****00011111100011**00**00***000****00**1111000111**00011001
1111001***11000111**00000000001**11**1111111001111**10000011
1111100111111***1111****100***111111111111111001111100011111
1111111111***0000000111000011111100001110**00000001110000111
1**11**111*000000**011000111111100010011000000**001100010011
00****00**00**00000000000000000000100000**001110000000100000
00***00****0000**0000011*0000000***00000000000000000***00000
00***00000000000000011***00***00***00***01000X000000***00***
000000000000**00***011****0***00****00**000011001100****00**
110000002100000000001**11**1111**11**11111000001111**11**111
1110000111****111***111111111111111111111111**11111111111111
