111111111111111111110**0000000111111111111111111111111111111**********1111111111
1**11**111*****11**1000000**0011111111111**11**111**11****111**11**11111****11**
00****00**0000****00**001110000111111110111000001100000**00000****00**000**00000
00***00**00000**00S0000000000000000000000000000000000000000000000000000000000000
00***000000000000011010000000002000000000100000000000000011*1100100000*110000000
0000000000*11000111100001100110111111110000011001110011000******000111**00011001
1100000021111100111111000001111111111111110000011111000001**1111001*****10000011
111000011111100111111111**111111111111111111**1111111110001111111001111100011111
11110000111100001111111111111111111111110**00000001111000011*1100000101100001111
**1110000011001***00**111000001**11**111000000**000011110011100000011000000111**
*1110011000110000000*1110011001110000011**0011100000000001000011000000001100111*
0000011111001100011000000***1100000000000000000000011000100010000110001111100000
000000011*0000011111000000011001000000000100000000****1000000000000000*110000000
10011000**21**00**00100110000000001100110000110011001100****0011001100**00011001
11000001*******00000**000001001100000111110000011100000*****0000000000**10000011
1110000011***************000111111**11111111**1111**********00001000001100000111
11000011111111111111010000011*1111111111*000000110111111111111000011110000000***
00000111**1**11**111011000000111000110000*11000**01**11**11100000111**0**000000*
001100111*111***00110000001100100@11000000000011*000****00**001100111*000000**00
1111100000000***000000011000011001100000000110000000***00**01111100000000**0000*
*11000000000**00000000000000001100000111*00000001000***00000*1100000000000000000
**000110010000002011001100110011100011**02001100*00000000000**000110010***001*00
**1000001111****1111000000000011000111**11000000111100000021**100000110000000000
11000001111111**11110000010000111***1111**00000**0111000011111000001110000000000
0**0000***1111111111111100001111111111111110000111011000000*1110000111011000000*
00000000**1**11**11100111100111**11**11111001000110**00011*0*****000110**00011*0
020000000011100000110000000100111***001100000100000*1100000000000000000*11000000
110000000000000000000110001000000***000000000***00000001100000000*11000000011000
11000100110100000000****10000000**000000***00***00010000000*00*00***11010000000*
01010000000000110011001100****0000002011**00****000*00110020***10000000*00110020
000111****110000011100000*****11****1111111**11**11100000011111**110001100000011
01111111**1111**1111**********1111**111111111111110**00000**11111111110**00000**
11111111111110000111111111111111111111111111000011111111111111111111110**0000***
11****11**1100010011**11****1111****11**00***100111**11*****1**11**11100000000**
000**00000000010000000000**000000**00000000000011000****0000111***00110200000000
000000000000***000000000000000000000000001100011000000**0000000***00001100000000
*11000000000***00***000000011**1100000001111100000110000000000**0000001100010011
**0001100100****00**10011000****0001100100**00**12111100011*00000020110101000000
**100000111**11**11111000001****1000001100000*****111100111111****1111000111****
1100011111111111111111111000111100011111**********11111001111111**111101111111**
1111111111111000011111111111111111000011*0000001100000000******0000**01110000111
00000111**1100010011**11100000**111000000*11000**00**000000***000000001100100011
001100111*0000100000*111001100*11100110000000011*0000000**0000000000200000010000
11***0000000***0000000000***1100000111110001100000000**0000*000000001100000***00
011000000000***00***0000000110000000011**00000001000000000001100100011***00***00
000001100100****00**100110000010011000**02001100*00***001*000000001010**00****00
00100000**1**11**111**0000010011000001**11000000110000000000****111000111**11**1
11000*****1111111111*****000111110000011**00000**00000000000**111111101111111111
**********1100001111111111111111110000111111111111***0000**011111111111111111111
1**11**111110011110000000111**00***100111**11**111**00000000*****11**1111**11**1
00****00**0010000000001100111*0000000110111000001100000000200000****001100000111
0000000000000100011011***000000110001100000000000000000000110000**00000000000000
1100100000000001****011000000011111000000100000000110010001100000000110000000010
****000111****001100000001100100**00**1200001100110000001010*1100011111100110000
1111001********0000000100000**00000*****1100000111****11100011110011111110000011
1111100111**********11000***************1111**1111**1111111011100111111111**1111
0**0000000***0000**011111111111111111111*11000001011111111110**0000***1111111111
000000**00**00000000111**11**1111**11**11000000110**1110000000000000**111**11**1
**0011100000000000201100***111**00****000011000000*11100110002000000001100***111
000000000000000000110000***0000**00***00100001100000000***1111000000000000***000
01000000001100100011000000**0000000***00000000000000000001101100010011000000**00
000011001100000010101102000000000000000000110011001001100000010100000011020000X0
1100000111****1110001111****1112000000110000000000**00000100000111****1111****11
1111**1111**111111101111**111111100001110000100000*****0001101111111**1111**1111
