111111111111111111110**0000000011000000***********1111111111
1**11**11100000111**000000**000**00011*01**11**1111111111111
00****00**001100111***001110000*1100000000****00**0111111110
00***00**011***000000000000000000001100000000000000000000000
00***0000001100000000100000000010000000*11001000000000000020
0S00000000000001100100001100110*00110020****0001110111111110
110000002100100000**110000011111000000111111001***1111111111
111000011111000*****1111**11110**00000**11111001111111111111
***0000**011110000111111111111***00000000**00000001100001111
**00000000001111001100000111***000000**0000000**0000000111**
00000000200000000100001100111*00**000000**00111000001100111*
0000000011011000100011***00000*0000**00000000000001111100000
1100100011****100000011000000000000000000100000000*110000000
0000001010001100****000001100100*100***00000110011**00011001
****11100000000*****00100000**00000000001100000111**10000011
**11111110**********11000*****00000000001111**11111100000111
11111111111111111111111111111111100001111111111111***0000000
1**11**1111**11*****11****11**11000100111**11**111*000000**0
111000001100****0000000**00000000010000000****00**00**000000
00000000000000**0000000000000000***0000000***00**0*0000**000
01000000001100000000*11000000000***00***00***000000000000000
0000110011111100011***0001100100****00**000000000000**00***0
11000001111111001111**100000111**11**11111000000210000000000
1111**11111111100111110001111111111111111110000111****100***
11111111111110000111***00000001111111111***0000**0*110000010
1**11**1111100010011*000000**01**11**111**000000001000000110
00****00**000010000000**00000000****00**00000000200011000000
00***00**000***00000*0000**00000***00**000000000111000011000
00***0000000***00***000000000000***0000011001000110000000000
000000000000****00**00*100***0000000000000000010100011001100
11000000211**11**11100000000001100000021****1110000000000000
1110000111111111111100000000001110000111**111111100000100000
*110000010111111111111110000111110000111**********011000000*
100000011011****11**001111001111000100111**11**1110**00011*0
0011000000000**000000000000100000010000000****00**0*11000000
10000110000000000000011000100000***0000000000000000000011000
0000000000*110000000****10000000***00***1100100000010000000*
0011001100**00011001001100****00****00******0001110*00110020
0000000000**1000001100000*****1**11**1111111001***1100000011
00001000001100011111**********111111111111111001110**00000**
1110000111111111111111110000110**00000000**00000001110000111
110001001111111111110011110011000000**00000000**001100010011
000010000001111111100000000100**00111000**001110000000100000
00***00000000000000001100010000000000000000000000000***00000
00***00***0000X00020****1000000100000000010000000000***00***
00****00**0111111110001100****0000110011000011001100****00**
1**11**111111111111100000*****110000011111000001111**11**111
11111111111111111111**********1111**11111111**11111111111111
