1111111111111111111111111111111111111111
1100011000000001110@10011001110000011100
1000110000001100111100121100000011001112
1001100000111110000000000001001111100000
1100000111011000000000100000001110000000
111000112102000110010S000000001100011001
1100011100011000001111000000210010000011
1112111111110001111111100001111100011111
1111111111111111111111000011111110000111
1211100111000001110000000111!01100010011
0010220012001100111200110011120000100000
0000100@10111110000011111000000010200000
00210000001110000000011000000000012000!0
0000000000000001100102000110010021000010
1100000021021000001110100000111101100111
1110000111110001111111000111111111111111
1100001111111100001111100001111111111111
0000011100211111001111000100111101111111
0011001111210000011100001000000001100011
1111100000011000111100021000000000000000
111000000011111000000000!002120010000000
0000011001001100111100012100100000000000
0210000011000001110210011011111100000021
1100011111111111111111111111111110000111
1111111111111100001111100001111110000111
0000011110001111001111000100111100010011
0011001111102000011100001000000000100000
1111100000011000111100212000000001200000
111000X000111110000000000002100010100211
1000011001001100111!00102100110001010002
2010000011000001111010211!011110@1101111
1100011111111111111111111111111111111111
