1111111111111111111111111111111111111111
0000011121111111111110011101111@011@1111
001100111011100000110000010000001010000!
1111100000000000000000020000000021000211
211000000001000000000011@000000001100000
000001100100001100110S000000000000000000
0110000011110000011111000000211100000021
1100011111111121111111100001111110000111
1100001111111000011111111111111110000111
0000011100110001001112111211111100010011
0011001110000010000000001000210000100000
1111100000000210000000000001020000200000
0110000000000000000000010000000000100001
00000110010000010010000000000000001000@1
2110000011110111011111000000211001100111
1100011111111111111111100001111111111111
1111111111111111111111100001111111111111
1121100111000001110011000100111011121111
0011200000001100111100001000000021100000
0010000000111110000000021000000000100210
0000200000111000000000001000210002100000
0000000000010001100100100100110000000000
1100000021001000001111011101111100000021
1110000111110001111111111111111110000111
0020000000111111111111111111111110000111
0000001000110211112111011001111100010011
0000111000110@11000011100000110000100000
0000000000101111100200000000000002100000
01000000001111211111010000000X0001200111
0000110011111011110100001100110001010002
1100000111111101111011000001111021101111
1111001111111000111111110111111111111111
