1111111111111111111111111111111111111111
1**11**1111**11**1111**11**1111100011000
00****00**00****00**00****00**1000110000
00***00***00***00***00***00***1001100000
00***0000000***0000000***000001100000111
0S000000000000000000000000000011100011**
11000000211100000021110000002111000111**
111000011111100001111110000111111***1111
1111111111111000011111111111111111111111
00000111**11000100111**11**1111**11**111
001100111*000010000000****00**111***0011
111110000000***0000000***00***000***0000
*11000000000***00***00***0000000**000000
**0001100100****00**00000000000000002011
**100000111**11**111110000002111****1111
1100011111111111111111100001111111**1111
1110000111111111111111100001111111111111
11000100111**11**11111000100111**11**111
000010000000****00**000010000000****00**
00***0000000***00***00***0000000***00***
00***00***00***0000000***00***00***00000
00****00**000000000000****00**0000000000
1**11**11111000000211**11**1111100000021
1111111111111000011111111111111110000111
1111000011111000011111111111111111111111
**1111001111000100111**11**1111**11**111
***00001110000100000111***0011111***0011
*11000111100***00000000***0000000***0000
111110000000***00***00**00000000**000000
001100111*00****00**00000020110X00002011
00000111**1**11**11111****111111****1111
111111111111111111111111**11111111**1111
