1100001111111111111111111111111111111111
0000011121000001112110111111111011110111
0011001110001100111200001100210000000010
1111100000111110000000101001100011100001
0110000000011000000000@010000000!0000000
1000011001100001100100000000000S00000000
0110000011001000001111000000211100000021
1100011111110001111111100001111110000111
1111000011111111111111100001111111111111
0111110011110001100111000100111!01110111
0010000111100@1100!00000100000000210000!
2110001111101111101000012000000002100011
1111100000110001111100111000010000000000
0011001111111121111000100000000000000000
00000111!0110101112111111111111100000021
1111111111111211111111111111111110000111
1111000011111111111111111111111100001111
0011110011121110011112111211110000011101
2100000111000021001011110000110011001112
0110001111000120002000021000001111100000
1111100000001100000000010000001110000000
0011001110000000000000000020111000011001
0000011100110000002111211111110010000011
1111111111111000011111110011111100011111
1110000111111100001111111111111111111111
1100010011111111001110111011110000011101
0000100000@00000011100110000000011001110
0021000000111000111100111001011111100000
000110001011111000000001000000011000X000
0000000010001100111000000000000000011001
1101100111000001111011000000210210000011
1111111111111111111111100001111100011111
