1111111111111111111111111111111111111111
1**11**1111**11**11100000111**1**11**111
00****00**00****00**001100111*00****00**
00***00***00***00***111110000000***00***
00***0000000***00000*11000000000***00000
0S000000000000000000**000110010000000000
11000000211100000021**100000111100000021
1110000111111000011111000111111110000111
1110000111111000011111110000111100001111
11000100111100010011**1111001100000111**
00001000000000100000***0000111001100111*
00***0000000***00000*1100011111111100000
00***00***00***00***1111100000*110000000
00****00**00****00**001100111***00011001
1**11**1111**11**11100000111****10000011
1111111111111111111111111111111100011111
1111000011111111111111111111111110000111
**1111001111***11***1**11**1111100010011
***00001111***11****00****00**0000100000
*1100011111**1111***00***00***00***00000
111110000011***1111100***0000000***00***
001100111*111***11**000000000000****00**
00000111**11***111**11000000211**11**111
1111111111111***111111100001111111111111
1100001111111100001111100001111111111111
00000111****1111001111000100111**11**111
001100111****000011100001000001110000011
1111100000*11000111100***000000000000000
*110000000111110000000***00***0100000000
**00011001001100111*00****0X**0000110011
**1000001100000111**1**11**1111100000111
1100011111111111111111111111111111**1111
