111111111111111111111111111111111111111111111111110**000000011111111111111111111
11000110001**11**11100000111**00000111**1**11**111000000**0000000111**1**11**111
100011000000****00**001100111*001100111*00****00****00111000001100111*00****00**
100110000000***00***1111100000111110000000***00***0000000000111110000000***00***
110000011100***00000*110000000*11000000000***000000100000000*11000000000***00000
11100011**0S00000000**00011001**0001100100000000000000110011**000110010000000000
11000111**1100000021**10000011**1000001111000000211100000111**100000111100000021
111***111111100001111100011111110001111111100001111111**111111000111111110000111
11111111111110000111111111111111110000111110000111111111111111110000111100001111
1**11**11111000100111**11**111**1111001111000100111**11**111**1111001100000111**
00****00**00001000001110000011***000011100001000001110000011***0000111001100111*
00***00***00***000000000000000*11000111100***000000000000000*1100011111111100000
00***0000000***00***0100000000111110000000***00***01000000001111100000*110000000
000000000000****00**0000110011001100111*00****00**0000110011001100111***00011001
11000000211**11**111110000011100000111**1**11**111110000011100000111****10000011
111000011111111111111111**1111111111111111111111111111**111111111111111100011111
11100001110**00000000**000000011110000111111111111111111111111111111111100001111
1100010011000000**00000000**00**111100111**11**1111**11**11100000111**00000111**
0000100000**00111000**00111000***000011100****00**111***0011001100111*001100111*
00***0000000000000000000000000*11000111100***00***000***000011111000001111100000
00***00***01000000000100000000111110000000***0000000**000000*110000000*110000000
00****00**00001100110000110011001100111*00000000000000002011**00011001**00011001
1**11**1111100000111110000011100000111**110000002111****1111**10000011**10000011
11111111111111**11111111**1111111111111111100001111111**111111000111111100011111
11111111111111111111111111111111111111111100001111111000011111110000111110000111
1**11**11100000111**1**11**11100000111**00000111**1100010011**111100111100010011
111***0011001100111*00****00**001100111*001100111*0000100000***00001110000100000
000***0000111110000000***00***1111100000111110000000***00000*11000111100***00000
00**000000*11000000000***00000*110000000*11000000000***00***111110000000***00***
0000002011**000110010000000000**00011001**0001100100****00**001100111*00****00**
11****1111**100000111100000021**10000011**100000111**11**11100000111**1**11**111
1111**11111100011111111000011111000111111100011111111111111111111111111111111111
11111111111100001111110000111111110000111110000111111000011111100001111111111111
11***11***00000111**00000111****111100111100010011110001001111000100111**11**111
1***11****001100111*001100111****00001110000100000000010000000001000001110000011
1**1111***11111000001111100000*11000111100***0000000***0000000***000000000000000
11***11111*110000000*110000000111110000000***00***00***00***00***00***0100000000
111***11****00011001**00011001001100111*00****00**00****00**00****00**0000110011
11***111****10000011**1000001100000111**1**11**1111**11**1111**11**1111100000111
111***11111100011111110001111111111111111111111111111111111111111111111111**1111
11000011111111000011110000111111100001111111000011111100001111100001111111111111
00000111****1111001100000111**1100010011**11110011**1111001111000100111**11**111
001100111****0000111001100111*0000100000***0000111***000011100001000001110000011
1111100000*110001111111110000000***00000*110001111*11000111100***000000000000000
*1100000001111100000*11000000000***00***1111100000111110000000***00***0100000000
**00011001001100111***0001100100****00**001100111*001100111*00****00**0000110011
**1000001100000111****100000111**11**11100000111**00000111**1**11**1111100000111
11000111111111111111110001111111111111111111111111111111111111111111111111**1111
11111111111111111111111000011111111111111111000011111111111111111111111100001111
1**11**1111**11**11111000100111**11**111**111100111**11**1111**11**11100000111**
00****00**00****00**000010000000****00*****000011100****00**1110000011001100111*
00***00***00***00***00***0000000***00****11000111100***00***00000000001111100000
00***0000000***0000000***00***00***00000111110000000***000000100000000*110000000
0000000000000000000000****00**0000000000001100111*00000000000000110011**00011001
110000002111000000211**11**111110000002100000111**11000000211100000111**10000011
1110000111111000011111111111111110000111111111111111100001111111**11111100011111
11111111111110000111111000011111110000111111111111111111111111111111111111111111
1**11**11111000100111100010011**11110011110001100011000110001**11**11111***11***
111000001100001000000000100000***00001111000110000100011000011100000111***11****
000000000000***0000000***00000*1100011111001100000100110000000000000001**1111***
010000000X00***00***00***00***111110000011000001111100000111010000000011***11111
000011001100****00**00****00**001100111*11100011**11100011**0000110011111***11**
11000001111**11**1111**11**11100000111**11000111**11000111**110000011111***111**
1111**1111111111111111111111111111111111111***1111111***11111111**1111111***1111
