1111111111111111111111111111111110000111
1**11**1111**11**1111**11**1111100010011
00****00**00****00**00****00**0000100000
00***00***00***00***00***00***00***00000
00***0000000***0000000***0000000***00***
00000000000S00000000000000000000****00**
1100000021110000002111000000211**11**111
1110000111111000011111100001111111111111
1111111111110000111111000011111111000011
11***11***00000111**00000111****11110011
1***11****001100111*001100111****0000111
1**1111***11111000001111100000*110001111
11***11111*110000000*1100000001111100000
111***11****00011001**00011001001100111*
11***111****10000011**1000001100000111**
111***1111110001111111000111111111111111
1110000111110000111111000011111110000111
110001001100000111**00000111**1100010011
0000100000001100111*001100111*0000100000
00***000001111100000111110000000***00000
00***00****110000000*11000000000***00***
00****00****00011001**0001100100****00**
1**11**111**10000011**100000111**11**111
1111111111110001111111000111111111111111
1110000111111111111111100001111111111111
11000100111**11**111110001001100000111**
000010000011100000110000100000001100111*
00***00000000000000000***000001111100000
00***00***010000000X00***00****110000000
00****00**000011001100****00****00011001
1**11**11111000001111**11**111**10000011
11111111111111**111111111111111100011111
