1111111111111111111111111111111110000111
12111011110000011101112111@1111100010011
0000000021001100111@00010100000000100000
0010200002111110000000001001@10002100000
0011@0000001100000000001000000001020000@
0S00000000020001100100000000000001000011
1100000021001000001111000000211021121111
1110000111110001111111100001111111111111
1110000111111100001111000011111111111111
1100010011021111001100000111101100011020
0000100000111000011100110011111021110111
0021200000011000111111111000001001111010
0000000001111110000011100000001100@11111
0002100000001100111011000110011111011100
1101101111000001110001100000111101111102
1111111111111111111111000111111111001111
1110000111111100001111000011111111111111
1100010011!01111001100000111021211110111
0000100000211000011100110011110010100000
0021000000111000111111111000000000200022
00!010000!111110000001100000000001000000
0021110011001100111010000110010000000000
1101101111000001110011100000111100000021
1111111111111111111111000111111110000111
1100001111111111111111100001111111111111
0000011100111110211111000100110000011112
0011001110111121001100001000000011001111
1111100000000011000000021000001111100000
2110000000000000000000021001021110000000
11000110010X0000201100110000100000011001
@110000011111102111110011001112110000011
1100011111111102111111111111111100011111
