1111111111111111111111111111111110000111
00000111**1**11**1111**11**1111100010011
001100111*00****00**00****00**0000100000
111110000000***00***00***00***00***00000
*11000000000***0000000***0000000***00***
**0001100100000000000S0000000000****00**
**10000011110000002111000000211**11**111
1100011111111000011111100001111111111111
1111111111111000011111111111111111111111
1**11**11111000100111**11**1111100011000
00****00**000010000000****00**1000110000
00***00***00***0000000***00***1001100000
00***0000000***00***00***000001100000111
000000000000****00**000000000011100011**
11000000211**11**111110000002111000111**
111000011111111111111110000111111***1111
1100001111111111111111000011111111111111
00000111**1**11**11100000111**00000111**
001100111*00****00**001100111*001100111*
111110000000***00***11111000001111100000
*11000000000***00000*110000000*110000000
**000110010000000000**00011001**00011001
**100000111100000021**10000011**10000011
1100011111111000011111000111111100011111
1111111111110000111111000011111100001111
00000111**00000111**00000111**00000111**
001100111*001100111*001100111*001100111*
1111100000111110000011111000001111100000
*11000X000*110000000*110000000*110000000
**00011001**00011001**00011001**00011001
**10000011**10000011**10000011**10000011
1100011111110001111111000111111100011111
