1111111111111111111111111111111111111111
1@01100111111101110011111011111211121111
001021001010201100010000@000110000020000
0000000000110111101@00210000010000100000
0000100000111211111100100000000002100000
000000000011101111020S000000000000000000
1100000021110111111011000000211100000021
1110000111111001111111100001111110000111
1111111111111111111100!00000001110000111
1021101111102111011100000000001100010011
0000010000111000001100001110000000100000
0002100010000000000000000000000010000000
0010000000010000000001000000000011!00000
0000000000000011001100001100110001100020
11000000211100000111110000011111@1110111
1110000111111121111111111011111111111111
1100001111111111111111111111111111000011
0000011100100111111110211@01111011110011
0011001112001100001100011200!00100000111
11111000000001100!0100110001010110001111
1110000000002110000000001000001111100000
0100011001000000000000000000000011001110
0!100000111100000021110000002100000111@0
1100011111111000011111100001111111111111
1110000111111111111111000011111111111111
1100010011101110011100000111010000011102
0000100000111000001100110011120011001110
0002100000000000000011111000001111100000
0000100000010000000X11100000002110000000
0011110021000011001121000110010000011001
1021101111110000011102100000112110000011
1111111111111101111111000111111100011111
