1111111111111111111111111111111111111111
00000111**1**11**1111**11**1111**11**111
001100111*00****00**00****00**00****00**
111110000000***00***00***00***00***00***
*11000000000***0000000***0000000***00000
**0001100100000000000S000000000000000000
**10000011110000002111000000211100000021
1100011111111000011111100001111110000111
1111111111111111111111110000111100001111
1**11**1111**11**111**1111001100000111**
1110000011111***0011***0000111001100111*
0000000000000***0000*1100011111111100000
010000000000**0000001111100000*110000000
00001100110000002011001100111***00011001
110000011111****111100000111****10000011
1111**11111111**111111111111111100011111
1111111111111000011111111111111110000111
1**11**11111000100111**11**1111100010011
00****00**000010000000****00**0000100000
00***00***00***0000000***00***00***00000
00***0000000***00***00***0000000***00***
000000000000****00**000000000000****00**
11000000211**11**11111000000211**11**111
1110000111111111111111100001111111111111
0**0000000111111111111100001111111111111
000000**001**11**11111000100111**11**111
**0011100000****00**0000100000111***0011
000000000000***00***00***00000000***0000
010000000000***0000000***00***00**000000
0000110011000000000000****00**0X00002011
110000011111000000211**11**11111****1111
1111**1111111000011111111111111111**1111
