1111111111111111111111000011111111111111
1021121111100110111100000111101@11110111
0010110011002100000000110011111110000011
0011100!00000!00000211111000000000000000
0001000000001000000011100000000100000000
00000000000S0000000011000110010000110011
1100000021110000002101100000111100000111
1110000111111000011111000111111111211111
1100001111111111111111110000111111000011
0000011101110110011100111100111111110011
0011001111001111002102100001110010000111
111110000000@100010011100011112110001111
0110000000001210000011111000001111100000
0000011001000000000000110011110011001111
01100000111100000021000001110200000111@0
1100011111111000011111111111111111111111
1100001111111111111111100001111111111111
0000011100100112111111000100111111100111
0011001111000011001000001000000000210002
1111100000002120001000002000000021000011
2110000000000010000000210000100010100000
0000011001000000000000010100100000000000
1110000011110000002110011101111100000021
1100011111111000011111111111111110000111
1110000111000000000000100000001111111111
110001001100000000000000001100100110@111
0000100000000011100000001110001110210011
0002100000000000000000000000000000210000
00011000@0010000000001000000000000000000
001@010011000011001100001100110X00002011
121110111111000001111100000111111@101111
1111111111111100111111112111111111011111
