1111111111111111111111000011111111000011
1101100111100111111100000111001011110011
0012100021000001000100110011100000000111
0001100102000000021111111000002110001111
0000100000001110000001100000001111100000
00000000000S0000000000000110010011001110
1100000021110000002121100000110000011100
1110000111111000011111000111111111111111
1110000111111111111111111111111111111111
1100010011100110!1111112111!001211111111
0000100000000021001111101111000000110010
00101000000010@000!012111110100000000112
0011200002000010000011001111110021000000
001011001000000000001110@111210000000000
1001101111110000002111@11111001100000021
1111111111111000011111110111111110000111
1111000011111000011111111111111111111111
21111100111100010011121110!1111111121111
0100000111000010000011100100110010100000
1110001111000020000000021000000021000000
1111100000000000021100010000000010100000
0011001111000021001100000020110000000000
0000011100101110111111002111111100000021
1111111111111111111111110111111110000111
1111111111111111111100000000001110000111
0000011110110001100000000010001100010011
0011001110100011000000001110000000100000
1111100000100110000000000000000011100000
2110000000110000011101000X000000@0000!00
1000011001111000110000001100110010000010
011000001111000111001100000111110110@111
1100011111111021111111112111111111111111
