1111111111111111111111111111111111111111
0000011100100110@11111011021111111100111
0011001110000021002100121100100000210001
111110000000011001010000000@000000200000
2110000000000@10000000000000000001000000
000001100100000000000S000000000000000000
2110000011110000002111000000211100000021
1100011111111000011111100001111110000111
1111111111111111111111110000111100001111
1001100111100110211102111100110000011120
1110000011111000001111000001110011001110
0000000000000102000011100011111111100000
0100000000000000000011111000000110000000
0000110011000000201100110011100000011001
1100000111111101111100000111011@10000011
1111001111111110111111111111111100011111
1111111111111000011111111111111110000111
1101121111110001001110011021111100010011
0000010001000010000000000100000000100000
0000100000000020000000211001110002100000
0000000000001010000000001000000010200021
0000000000000011002100000000000001010000
1100000021121111011111000000211001101111
1110000111111111111111100001111111111111
0!00000000111111111111100001111111111111
0000001100100111111111000100111001102111
0100111000000001000100001000001110210011
0000000000000000000000211000000000010000
0100000000002100000000100001100000000000
0000110011000000000000001000010X00002011
1100000111110000002110111001111110211111
1111011111111000011111111111111111011111
