111111111111111111110110000000011000000101000001001111111111
111110111100000111010000001100001000111011111011111111111111
000101001000110011101000111000001100000000111100000111111110
000000000011101000000000000000000001100000000000000000000000
000000000001100000000100000000010000000111001000000000000020
0S0000000000000110010000110011010011002000000001110111111110
110000002100100000111100000111110000001111110011111111111111
111000011111000010001111001111011000000111111001111111111111
010000001011110000111111111111001000000000000000001100001111
000000000000111100110000011110000000001000000000000000011100
000000002000000001000011001111001100000000001110000011001111
000000001101100010001110000000100001000000000000001111100000
110010001100001000000110000000000000000001000000001110000000
000000101000110011100000011001001100001000001100111100011001
1@0111100000000111000010000001000000000011000001110110000011
011111111001000101101100011011000000000011111011111100000111
111111111111111111111111111111111000011111111111110010000000
100110011111011001001110001101110001001111111001110000000100
111000001100001000000001100000000010000000001000000010000000
000000000000000100000000000000000100000000210001101000000000
010000000011000000001110000000001010000000000000000000000000
000011001111110001110000011001001000000000000000000000001010
110000011111110011110010000011101110111111000000210000000000
111110111111111001111100011111111111111111100001110100100211
111111111111100001110100000000111111111111100000001110000010
110110011111000100111000000110101111011110000000001000000110
001011000000001000000011000000000100001100000000200011000000
001110000000010000001000001000001000011000000000111000011000
000000000000000000000000000000000100000011001000110000000000
000000000000000000100001000010000000000000000010100011001100
110000002110011011110000000000110000002100101110000000000000
111000011111111111110000000000111000011100111111100000100000
011000001011111111111111000011111000011110010001010110000001
100000011011101011110011110011110001001111011101110100001100
001100000000001000000000000100000010000000011000110011000000
100001100000000000000110001000000000000000000000000000011000
000000000011100000001011100000000110011111001000000100000001
001100110000000110010011000001001100001010100001110100110020
000000000000100000110000000011110111011111110010001100000011
000010000011000111111101110001111111111111111001110110000000
111000011111111111111111000011010000000000000000001110000111
110001001111111111110011110011000000110000000001001100010011
000010000001111111100000000100110011100001001110000000100000
000010000000000000000110001000000000000000000000000000000000
00010000100000X000200110100000010000000001000000000000100000
000010001001111111100011000000000011001100001100110001010001
110110011111111111110000010110110000011111000001111001110111
111111111111111111110100111110111100111111110011111111111111
