111111111111110000111100001111111111111111111111110110000000
000001110011111100110000011110000001111111111001111100001100
001100111001000001110011001110001100111000000000100111000000
11111000001110001111111110000011111000000S000000000000011000
011000000011111000001110000000111000000011001000001100000000
110001100100110011111000011001100001100111110001110000110020
001000001100000111011110000011111000001111110011111100000011
110001111111111111111100011111110001111111111001110100000001
001000010001100001001111111111111111111111111111111110000111
010000000001000000001021111111111111111110011101111100010011
000000002000000000201111000011000101000011100000110000100000
000000001100000000110001110000000000000000000000000010100000
110010011111001001110010000000110010000001000000000011000111
000000111100000011110000002011111100011100001100110010010001
000011111100001111111111011111111100111111000001111101100111
011111111100111111111111001111111110011111111111111111111111
111100001100000000101111111111111000000011111111110110000001
111111001110000000001111111111000000000011000011011010001100
001000011100000000200010000000001100000000000000100111000000
011000111100000000110000100101000001000000000000000000011000
111110000011001001110000000000000000000001100000001100000000
001100111000000011110000000000000000000010000110010100110020
000001110010001111111100000021000000000001100000111100000011
111111111110111111111110000111011111111011000111110000000011
111100001101100000010010000000011000010011110000111100001111
1111110011!0100011001000000000010000000010111100110000011111
110000011100110000000011000000000000002001000001110011001110
111000111100000110000000001000000000001101100011111111100000
111110000011000000000000000000110010011111111000001110000000
001100111100001100200011000100000000111100110011101100011001
000001110011000000110000000000011011111100000111001010000011
111111111100100000101110111011111111111111111111111100011111
111011110111111111110010000000111000011111111111111100001111
110110011111000110000000000210110001001110011101110000011120
0000000000100@1100000000000000000010000000010000010011001111
000000001110011000000000011000000000000000000000001111100000
110010010111000001110000000000001000000011001000001110000000
010100011111100011010011001100001000000111110001111000011001
111100100111000111100000000000100110111111110011111010000011
111110011111111111111000100110111111111111111001111100011111
111111111100000000001110000111111000011101000000001110000111
111111111100000000101100011111110001001100000010001100010011
000101001000000000000000000000000010000010001110000000100000
000010010000000010000011000000001010000000000000000010100000
000000000000000000001100100101000010011101000X00000001100000
000000000000000011001100010101000000000100001100110001010010
110000002100000000001101110111110110111111000001111111110111
111000011101001110011111111111111111111111111111111111111111
