11111111111111111111000000000011111111111111111111111111111100100000001111111111
10011111110100011001000000010011111111111111111111001101101111011101111101101111
00001000100000100000010011100001111111101110000011000000000000101000010001000000
000000000000001100S0000000000000000000000000000000000000000000000000000000000000
00011000000000000011010000000002000000000100000000000000011011001000000110000000
00000000000110001111000011001101111111100000110011100110001010100001110000011001
11000000211111001111110000011111111111111100000111110000011011110011010010000011
11100001111110011111111110111111111111111111011111111110001111111001111100011111
11110000111100001111111111111111111111110100000000111100001101100000101100001111
10111000001100100100111110000010011011110000001000001111001110000001100000011110
11110011000110000000011100110011100000111000111000000000010000110000000011001110
00000111110011000110000000111100000000000000000000011000100010000110001111100000
00000001100000011111000000011001000000000100000000100010000000000000000110000000
10011000012100000100100110000000001100110000110011001100000000110011000100011001
11000001101000000000000000010011000001111100000111000001100000000000000010000011
11100000110101101000001000001111110111111111011111000110000000001000001100000111
11000011111111111111010000011011111111110000000110111111111111000011110000000111
00000111101001100111011000000111000110000011000000100110011100000111000010000000
001100111111100100110000001100100@1100000000001110000000000000110011100000000100
11111000000001010000000110000110011000000001100000001100001011111000000001100001
01100000000000000000000000000011000001111000000010001100000001100000000000000000
10000110010000002011001100110011100011010200110000000000000000000110010010001000
01100000111100011111000000000011000111111100000011110000002110100000110000000000
11000001111111011111000001000011110011110000000110111000011111000001110000000000
00100001001111111111111100001111111111111110000111011000000111100001110110000001
00000000001011101111001111001111011001111100100011010000111001100000110000001110
02000000001110000011000000010011100000110000010000001100000000000000000011000000
11000000000000000000011000100000000000000000011100000001100000000011000000011000
11000100110100000000101110000000010000001100000000010000000000100000110100000001
01010000000000110011001100011000000020111100000@00010011002010210000000000110020
00011100011100000111000000001111000111111110111101110000001111111110001100000011
01111111101111011111001001101011110011111111111111010000000111111111110110000011
11111111111110000111111111111111111111111111000011111111111111111111110000000100
11000011001100010011101100101111110011000000010011100110011010011011110000000011
00011000000000100000000000100000011000000000000110001110000011100000110200000000
00000000000000000000000000000000000000000110001100000011000000000000001100000000
11100000000000100000000000011111100000001111100000110000000000110000001100010011
10000110010011000010100110000101000110010001001012111100011000000020110101000000
11100000111101100111110000011110100000110000010000111100111111010111110001111011
11000111111111111111111110001111000111111001000110111110011111110011110111111110
11111111111110000111111111111111110000110000000110000000000001000000001110000111
00000111101100010011101110000000111000000011000100010000000110000000001100100011
00110011100000100000111100110011110011000000001100000000000000000000200000010000
11010000000001000000000001011100000111110001100000000000000000000000110000000100
01100000000001100000000000011000000001100000000010000000000011001000110000000100
00000110010010010010100110000010011000100200110000001100100000000010100100011100
00100000111111111111000000010011000001111100000011000000000001111110001110111101
11000001101111111111010110001111100000110100000010000000000000111111101111111111
10000000011100001111111111111111110000111111111111011000010011111111111111111111
10011111111100111100000001110000001100111101110111000000000001110110011111011001
00111100100010000000001100111000000001101110000011000000002000001011001100000111
00000000000001000110110110000001100011000000000000000000001100001000000000000000
11001000000000010111011000000011111000000100000000110010001100000000110000000010
00000001110011001100000001100100000000120000110011000000101011100011111100110000
11110010111011000000001000000000000100011100000111010011100011110011111110000011
11111001111001011111110000110100011111001111101111001111111011100111111111001111
01000000001000000000111111111111111111110110000010111111111100100000111111111111
00000011000100000000111101100111100111111000000110111110000000000000111110111101
01001110000000000020110000011101000101000011000000111100110002000000001100000111
00000000000000000011000000100001000000001000011000000001101111000000000000010000
01000000001100100011000000010000000110000000000000000000011011000100110000001100
000011001100000010101102000000000000000000110011001001100000010100000011020000X0
11000001111010111000111100001112000000110000000000010000010000011100111111011011
11110111110011111110111100111111100001110000100000100000001101111111101111001111
