1111111111111111111111110000111111000011
1001100111101110011111111100111011110011
0000000001000111001100000001000000000110
0010000100000000000101100000000110001100
0010200000001000000011111000001111100000
0S00000000000000000000110011110011001111
1100000021110000002100000111100000011100
1110000111111000011111111111111111111111
0010000000111111111111111111111111111111
1000000000110001101010111101111100011000
001000000010001110100001010011100@110000
0000011000111111100000000000001001100000
0000000000110001111111001000001100000111
0001000100111110110111110001111110001100
0000000000110001110011110011111100011100
0000000000111010111111111001111111101111
1100000000111000000011100001110010000000
1000000100100000001011000100111000000010
0000000000000000000000001000000000000000
0000010000100000000000000000000000001000
0000000000000000000000101000000000000000
0001001000000000100000000000100011001110
0000000000000000000010111101110000000000
0000000000000000000011111111110000100101
0020000110111000011111111111111110000111
1100000000110001111111111111111100010011
0000000020000000000001111111100000100000
0X00000011001110000000000000000000100000
1100100011111000000000000000200010100010
0000001011110111010001111111100000210011
0110111000111110111111111111111011111111
0111111111111111111111111111111111111111
