1111000011111111111111111111111000000000
1111110011101110111110011001111000000000
1110000111000000001100010000110000000000
0110001111000010000000011001000000010000
1111100000000110000000101000000000000000
001100111000000000000S000000000010000000
0000011101110000002111000000210000000000
1111111111111000011111100001110000000010
1100001111111000011111111111111111111111
0000011110110001001111011001111101100111
0011001111000010000000110000010001010000
1111100000001010000000100001000010100100
0110000000000010011000011000000000100000
0000011001001111000000000000000000000000
0110000011101110111111000000211100000021
1100011111111111111111100001111110000111
0110000000111111111111000011111111000011
0000000000000001110000000111101011110011
1100111000001100111000110011110100000111
0000000000111110000011111000000110001111
0100000000111000000011100000001111100000
0000110011000001100111000110010011001110
1100000111001000001111100000110000011110
1111101111110001111111000111111111111111
1100001111111111111111100001110010000000
0000011100101111111111000100110000001100
001100111011100@001100001000000000111000
1111100000000110000000100000000000000000
01100000000011000000000100000001000X0000
1000011001000000201100100100010000110011
0110000011110101111110111111111100000111
1100011111111110111111111111111111111111
