1111111111111111111111111111111111111111
110001100000000111**1**11**11100000111**
1000110000001100111*00****00**001100111*
1001100000111110000000***00***1111100000
1100000111*11000000000***00000*110000000
11100011****000110010S00000000**00011001
11000111****100000111100000021**10000011
111***1111110001111111100001111100011111
1111111111111111111111000011111110000111
1**11**11100000111**00000111**1100010011
00****00**001100111*001100111*0000100000
00***00***1111100000111110000000***00000
00***00000*110000000*11000000000***00***
0000000000**00011001**0001100100****00**
1100000021**10000011**100000111**11**111
1110000111110001111111000111111111111111
1100001111111100001111100001111111111111
00000111****1111001111000100111**11**111
001100111****0000111000010000000****00**
1111100000*11000111100***0000000***00***
*110000000111110000000***00***00***00000
**00011001001100111*00****00**0000000000
**1000001100000111**1**11**1111100000021
1100011111111111111111111111111110000111
1111111111111100001111100001111110000111
00000111****1111001111000100111100010011
001100111****000011100001000000000100000
1111100000*11000111100***0000000***00000
*11000X000111110000000***00***00***00***
**00011001001100111*00****00**00****00**
**1000001100000111**1**11**1111**11**111
1100011111111111111111111111111111111111
