1111111111111111111111111111111100001111
10011111111@0110211111011021110000011102
0000010010111000001100111000100011001110
0000000100000000000000@10001111111100000
0010000000010000000000110000001110000000
000000000000001100110S000000001100011001
1100000021110000011111000000212110000011
1110000111111110111111100001111100011111
1100001111111100001111000011111111000011
0000011100001111001100000111001011110011
0011001110100000011100110011111110000111
1111100000011000111111111000001110001111
0110000000111110000021100000001111100000
0000011001001100111100000110010011001110
2110000011000001111011100000110000011100
1100011111111111111111000111111111111111
1100001111110000111111110000111111000011
0000011121000001110021111100110011110011
001100111@0011001110000000011121@0000111
1111100000111110000021100011110110001111
0110000000011000000011111000001111100000
0100011001010001100100110011100011001111
00100000110!1000001100000111210000011102
1100011111110001111111111111111111111111
1110000111011000000011000011111100001111
1100010011000000020000000111000000011100
0000100000210011100000110011110011001111
0000000000000000000011111000001111100000
000120010001000X000011100000001110000000
00010100110000110011@0000110012100011001
1011100111110000011111100000111010000011
1111111111111110111111000111111100011111
