1111111111111111111111111111111110000111
1021110111110110211110011111111100010011
0011100000000011001100110000020000100000
00100000010000@00!0100111000000010000000
0001100000000110000000111000000001200020
00000000000S0000000000000000000000010002
1100000021110000002111000000211001111111
1110000111111000011111100001111111111111
1111111111110000111111000011111111000011
1100011212000001110@00000111211011110011
1210110010001100111100110011100110000111
1001111110111110000011111000000110001111
1111011111011000000001100000001111100000
1110101100000001100112000110010011001110
1100211100101000001111100000110000011111
1110211111110001111111000111111111111111
1110000111110000111111000011111110000111
1100010011000001110100000111021100010011
0000100000001100111000110011110000100000
00000000001111100000111110000000@1000000
00000001002110000000@1100000000012000020
0000020010000001100110000110010011@00010
11011001110@1000001121100000111001110111
1111111111110001111111000111111111111111
1110000111111111111111100001111111111111
11000100111021100111110001001100000111@0
0000100000111000001100001000000011001110
0011100000000000000000012000001111100000
0001000210010000000X00001000021110000000
0011000021000011001100212100101100011001
1101102111110000011110011011112110000011
1111111111111121111111111111111100011111
