1111111111111111111111000011111111111111
1**11**1111**11**11100000111**1**11**111
111***00111110000011001100111*00****00**
000***00000000000000111110000000***00***
00**0000000100000000*11000000000***00000
00000020110000110011**000110010S00000000
11****11111100000111**100000111100000021
1111**11111111**111111000111111110000111
1111111111111111111111000011111100001111
1**11**11111***11***00000111**00000111**
00****00**1***11****001100111*001100111*
00***00***1**1111***11111000001111100000
00***0000011***11111*110000000*110000000
0000000000111***11****00011001**00011001
110000002111***111****10000011**10000011
1110000111111***111111000111111100011111
1110000111111100001111111111111110000111
1100010011**111100111**11**1111100010011
0000100000***000011100****00**0000100000
00***00000*11000111100***00***00***00000
00***00***111110000000***0000000***00***
00****00**001100111*000000000000****00**
1**11**11100000111**11000000211**11**111
1111111111111111111111100001111111111111
1110000111111000011111111111111111111111
1100010011110001001100000111**1**11**111
00001000000000100000001100111*00****00**
00***0000000***00000111110000000***00***
00***00***00***00****11000X00000***00000
00****00**00****00****000110010000000000
1**11**1111**11**111**100000111100000021
1111111111111111111111000111111110000111
