111111111111111111111111111111111111111111111111110!0000000011111111111111111111
11001112101121101111000001111000000111011121121111000000010000000111001101121111
10101110000011000012001100111100110011100000100001010011100000110011120010100000
1!011110210000100011111110000011111000000021000001000000000011111000000000100110
11000111110010000000011000000001100000000010000000010000000001100000000021100000
11112111210S00000000000001100121000110010000000000000011001101000110010000000000
11001111111100000021001000001100100000111100000021110000011102100000111100000021
11111011111110000111110001111111000111111110000111111121111111000111111110000111
11111111111110000111111111111111110000111110000111111111111111110000111100001111
10011021111100010011101110011102111100111100010011121111011111111100110000011120
00100100000000100000111000001111100001110000100000111000001101100001110011001110
00010002100021100000000000000011100011110000200000000000000021100011111111100000
00000000000000000021010000000011111000000001000012010000000011111000001110000000
00000000000002100001000011001100110011100002000001000011001100110011100100011001
1100000021111111111111000001110000011100111111@111110000011100000111011010000011
11100001111111111111111121111111111111111111111111111110111111111111111100011111
11100001110000000000021000000011110000111111111111111111111111111111111100001111
11000100110000000200000000000021111100111211101111121110111100000111000000011100
00001000000!00111000210011100000100001110010210001111101001100110011100011001110
00100000000000000000000000000021100011110011000100000010000011111000001111100000
00001002110100000000010000000011111000000000100000000100000021100000002110000000
00210000000000110011000011001100110011120000000000000000201111000110010100011001
10211101111100000111110000011100000111001100000021110002111100100000110010000011
11111111111111211111111100111111111111111110000111111102111111000111111100011111
11111111111111111111111111111111111111111100001111111000011111110000111110000111
12111001110000011101100111011100000111000000011100110001001110111100111100010011
11111100110011001112000000000100110011110011001112000010000000200001110000100000
00000000001111100000000020000111111000001111100000000020000001100011110000200000
00000000000110000000002110000011100000002110000000002110010011111000000001000212
00000020111100011001000000000000000110010000011001001010001000110011100000120001
11211011110010000011110000002100100000112110000011100111011100000111001001111111
11111011111100011111111000011111000111111100011111111111111111111111111111111111
11111111111100001111110000111111110000111110000111111000011111100001111111111111
11000110000000011121000001110002111100111100010011110001001111000100111111100111
11211112100011001112001100111000000001110000100000000010000000001000001110000011
11011110011111100000111110000001100011110000200000000210000000000000000000000000
11000111111110000000011000000011111000000010100100001000000000021002100100000000
11112111101100011001000001100100110011110020100002001112000100101000010000110011
11001111100110000011021000001100000111111101110111110110011110011111111100000111
11100011111100011111110001111111111111111111111111111111111111111111111111211111
11000011111111000011110000111111100001111111000011111100001111100001111111111111
0000011102121111001100000111101100010011001111001121111100111100010011121110@111
00110011111110000111001100111100001000001000000111000000011100001000001110000011
11111000001110001111111110000000212000000110001111011000111100211000000000000000
01100000001111100000211000000000000000001111100000111110000000001000100100000000
00000110010011001111000001100100000000000011001112001100111000000100110000110011
21100000110000011100211000001112111021110000011101000001110010111111111100000111
11000111111111111111110001111111111111111111111111111111111111111111111111101111
11111111111111111111111000011111111111111111000011111111111111111111111100001111
11111111111101110111110001001111211101112111110011100110211110@11211110000011122
00000100000010010021000010000000110000010000000111000000000211100000110011001111
00001000210000000000001120000000010000011110001111002100021000000000001111100000
00211000000000000000001010000000100000001111100000001010000001000000000110000000
00000000000000000000000000000000000000000011001110000000000000001100112100011001
11000000211100000021101110011111000000210000011100110000002111000001110110000011
11100001111110000111111111111111100001111111111111111000011111110011111100011111
11111111111110000111111000011111110000111111111111111111111111111111111111111111
10211001111100010011110001001100111100111101111212110001102110111211111100211212
11100000110000100000000010000000000001111102110000100011001011100000111010111001
00000000000000000000000110000001100011111001111210100111102000000000001211111102
010000000X0021200210000000001011111000001110111111110021111101000000001101211111
00001100110000110001000102000100110011111111211101111110112100001100111111011110
11000001111021100111100110011100000111111101111100110001110011000001111101111100
111121111111111111111111111111111111111111100!1111111210111111112111111110101111
