11111111111111111111111111111111111111111111111111001000000011111111111111111111
11000110001111100111000001110000000111111111100111000000010000000111101001110111
10001100000000100001001100111000110011100010010001000011100000110011100000100001
10011000000010000000111110000011111000000001100011000000000011111000000000100010
11000001110001000000111000000001100000000000000000010000000001100000000010100000
11100011010S00000000100001100101000110010000000000000011001110000110010000000000
11000111001100000021011000001100100000111100000021110000011101100000111100000021
11111111111110000111110001111111000111111110000111111101111111000111111110000111
11111111111110000111111111111111110000111110000111111111111111110000111100001111
11111001111100010011100111011110111100111100010011100110111110111100110000011100
00001000010000100000111000001110000001110000100000111000001100000001110011001111
00001001100011000000000000000011100011110011100000000000000001100011111111100000
00101000000001100000010000000011111000000011100101010000000011111000001110000000
00000000000000000000000011001100110011110000000011000011001100110011101000011001
11000000211111110111110000011100000111011011100111110000011100000111111110000011
111000011111111111111111111111111111111111111111111111!0111111111111111100011111
111000011101100000000@1000000011110000111111111111111111111111111111111100001111
11000100110000001100000000010000111100111111101111101110111100000111110000011111
00001000000100111000110011100001100001110010000000111011001100110011110011001111
00010000000000000000000000000011100011110010100111000000000011111000001111100000
00001001100100000000010000000011111000000010000000001000000001100000000110000000
00100000110000110011000011001100110011110000000000000000201110000110010100011001
11011001111100000111110000011100000111001100000021110110111111100000110010000011
11111111111111101111111101111111111111111110000111111100111111000111111100011111
11111111111111111111111111111111111111111100001111111000011111110000111110000111
11011111110000011100110111111100000111100000011111110001001100111100111100010011
11100100110011001111000011000100110011100011001111000010000011000001110000100000
000110000011111000000000@000111111100000111110000000!000000011100011110010000000
00010000001110000000001110000011100000000110000000001010011111111000000011000010
00000020111000011001000000000010000110010000011001001000000100110011110011110000
11010011111010000011110000002110100000110110000011110110111100000111101101111111
11110111111100011111111000011111000111111100011111111111111111111111111111111111
11111111111100001111110000111111110000111110000111111000011111100001111111111111
11110111010000011111000001111010111100111100010011110001001111000100111101101111
11001100110011001111001100111100100001110000100000000010000000001000001110000011
11011111011111100000111110000011100011110010000000001000000000011000000000000000
11111111110110000000011000000011111000000001000111000100001100010001010100000000
11110011001000011001000001100100110011100001110011001001000000101100010000110011
11100111100010000011001000001100000111011001110111110110011110011001111100000111
11111111111100011111110001111111111111111111111111111111111111111111111111011111
11000011111111000011110000111111100001111111000011111100001111100001111111111111
00000111110111110011000001111011000100110111110011001111001111000100111101110111
00110011101100000111001100111100001000001100000111011000011100001000001110000011
11111000000110001111111110000000110000000110001111011000111100111000000000000000
11100000001111100000011000000000000001001111100000111110000000101000000100000000
11000110010011001111000001100100000100000011001110001100111000001000100000110011
01100000110000011110011000001111111001110000011110000001110111011101111100000111
11000111111111111111110001111111111111111111111111111111111111111111111111001111
11111111111111111111111000011111111111111111000011111111111111111111111100001111
10111111111011101111110001001111011001110111110011101110011111011111110000011111
00100100110000000010000010000000011000010010000111000000001011100000110011001110
00001000100010100100000000000000001001010110001111001210001000000000001111100000
00000000000001100000000110001000011000001111100000000110000001000000000110000000
00000000000000000000000110000000000000000011001111000000000000001100110000011001
11000000211100000021101110011111000000210000011101110000002111000001110110000011
11100001111110000111111111111111100001111111111111111000011111111111111100011111
11111111111110000111111000011111110000111111111111111111111111111111111111111111
11111001111100010011110001001111111100111100011000110001100011011001111100111111
11100000110000100000000010000001100001111000110000100011000011100000111100110110
00000000000000100000000010000001100011111001100000100110000000000000001001111101
010000000X0001000000000000000011111000001100000111110000011101000000001100011111
00001100110000110000000101001000110011111110001101111000110000001100111110011100
11000001111101110111100111011100000111101100011100110001110011000001111101111110
11110011111111111111111111111111111111111110011111111111111111111111111111101111
