1111111111111111111111111111111111111111
1**11**1111**11**1111**11**11100000111**
00****00**00****00**00****00**001100111*
00***00***00***00***00***00***1111100000
00***0000000***0000000***00000*110000000
00000000000S000000000000000000**00011001
110000002111000000211100000021**10000011
1110000111111000011111100001111100011111
1110000111111111111111000011111111111111
11000100111**11**11100000111**1100011000
000010000000****00**001100111*1000110000
00***0000000***00***11111000001001100000
00***00***00***00000*1100000001100000111
00****00**0000000000**0001100111100011**
1**11**1111100000021**1000001111000111**
111111111111100001111100011111111***1111
1111111111110000111111111111111111111111
110001100000000111**00000111**1100011000
1000110000001100111*001100111*1000110000
1001100000111110000011111000001001100000
1100000111*110000000*1100000001100000111
11100011****00011001**0001100111100011**
11000111****10000011**1000001111000111**
111***111111000111111100011111111***1111
1110000111111111111111111111111110000111
110001001100000111**00000111**1100010011
0000100000001100111*001100111*0000100000
00***000001111100000111110000000***00000
00***00****11000X000*11000000000***00***
00****00****00011001**0001100100****00**
1**11**111**10000011**100000111**11**111
1111111111110001111111000111111111111111
