1111111111111111111111111111111111111111
1211101111000001112110011101111021110111
001120000000110011110010000010001210000!
00!0000100111110000000012001100010000211
0010000000011000000000100000000001000000
000000000000000110010S000000000000000000
1100000021001000001111000000211100000021
1110000111110001111111100001111110000111
1100001111111100001111111111111110000111
0000011100011111001112111211111100010011
0011001110100000011111100000110000100000
1111100000011000111100000000000001200000
01100000001111100000010000000000!0100000
2100011001001100111000001100110011010011
0110000011000001110011000001111101100111
1100011111111111111111110111111111111111
1110000111111111111111111111111111000011
1100010011102112111110011011110011110011
0000100000001100002100010100000000000111
0021000000000100001000000000001110001111
0001100021001010000000000000001111100000
0010000000000000000000000000000011001110
1111100111110000002111000000210000011101
1111111111111000011111100001111111111111
1111111111111000011111111111111111111111
000001110011000100111@011211111011100111
0011001110000010000011101100111110000011
1111100000002100000000010100000000000000
111000000000!010002100000000000021000000
000001100100000000020X000020110000002011
0010000011121110111111210111111100021111
110001111111111111111111!011111111001111
