1111111111111111111111111111111111111111
1**11**1111**11**1111**11**11111***11***
00****00**00****00**00****00**1***11****
00***00***00***00***00***00***1**1111***
00***0000000***0000000***0000011***11111
00000000000S000000000000000000111***11**
11000000211100000021110000002111***111**
111000011111100001111110000111111***1111
1100001111110000111111110000111100001111
00000111**00000111****1111001100000111**
001100111*001100111****0000111001100111*
11111000001111100000*1100011111111100000
*110000000*1100000001111100000*110000000
**00011001**00011001001100111***00011001
**10000011**1000001100000111****10000011
1100011111110001111111111111111100011111
11100001110**000000011111111111110000111
1100010011000000**001**11**1111100010011
0000100000**0011100000****00**0000100000
00***00000000000000000***00***00***00000
00***00***010000000000***0000000***00***
00****00**0000110011000000000000****00**
1**11**111110000011111000000211**11**111
11111111111111**111111100001111111111111
1111111111111111111111111111111111111111
11***11***1**11**11100000111**1**11**111
1***11****00****00**001100111*111***0011
1**1111***00***00***1111100000000***0000
11***1111100***00000*11000X00000**000000
111***11**0000000000**000110010000002011
11***111**1100000021**1000001111****1111
111***1111111000011111000111111111**1111
