1111111111111111111111111111111111111111
1**11**11100000111**1**11**1111**11**111
00****00**001100111*00****00**00****00**
00***00***111110000000***00***00***00***
00***00000*11000000000***0000000***00000
0000000000**000110010S000000000000000000
1100000021**1000001111000000211100000021
1110000111110001111111100001111110000111
110000111111110000110**00000001110000111
00000111****11110011000000**001100010011
001100111****0000111**001110000000100000
1111100000*110001111000000000000***00000
*1100000001111100000010000000000***00***
**00011001001100111*000011001100****00**
**1000001100000111**11000001111**11**111
110001111111111111111111**11111111111111
1100001111111100001111100001111111111111
00000111****11110011110001001100000111**
001100111****00001110000100000001100111*
1111100000*11000111100***000001111100000
*110000000111110000000***00****110000000
**00011001001100111*00****00****00011001
**1000001100000111**1**11**111**10000011
1100011111111111111111111111111100011111
11100001110**000000011100001111110000111
1100010011000000**0011000100111100010011
0000100000**0011100000001000000000100000
00***00000000000000000***0000000***00000
00***00***01000X000000***00***00***00***
00****00**000011001100****00**00****00**
1**11**11111000001111**11**1111**11**111
11111111111111**111111111111111111111111
