1100001111111111111111111111111111111111
00000111**00000111**1**11**1111**11**111
001100111*001100111*00****00**00****00**
1111100000111110000000***00***00***00***
*110000000*11000000000***0000000***00000
**00011001**0001100100000000000S00000000
**10000011**1000001111000000211100000021
1100011111110001111111100001111110000111
1111000011111111111111100001111111111111
**1111001111***11***11000100111**11**111
***00001111***11****000010000000****00**
*1100011111**1111***00***0000000***00***
111110000011***1111100***00***00***00000
001100111*111***11**00****00**0000000000
00000111**11***111**1**11**1111100000021
1111111111111***111111111111111110000111
1111000011111111111111111111111100001111
**111100111**11**1111**11**11100000111**
***000011100****00**111***0011001100111*
*11000111100***00***000***00001111100000
111110000000***0000000**000000*110000000
001100111*00000000000000002011**00011001
00000111**110000002111****1111**10000011
111111111111100001111111**11111100011111
1110000111111100001111111111111111111111
1100010011**111100111**11**11100000111**
0000100000***000011100****00**001100111*
00***00000*11000111100***00***1111100000
00***00***111110000000***00000*11000X000
00****00**001100111*0000000000**00011001
1**11**11100000111**1100000021**10000011
1111111111111111111111100001111100011111
