1111111111111111111111111111111111111111
102110011110211@111111011211111102111000
0001000010001010001000101100101100112101
000!000001000000000000200000211011111010
0010100000001000000000102000001100111111
00000000000S0000000000000000001110201101
1100000021110000002111000000211101011110
1110000111111000011111100001111112001111
1100001111110000111111110000111100001111
0000011121000001111!00111100110000011100
0011001110001100111100200001110011001110
1111100000111110000011100011111111100000
0110000000111000000011111000002110000000
2100011001110001100100110011101@00011001
0210000011101000001100000111001110000011
1100011111110001111111111111111100011111
1110000111002000000011111111111110000111
1100010011000000000010011211111100010011
0000100000210011100000000200100000100000
0011000000000000000000110000010000200000
0001000@10010000000000110000000010100000
0000120010000011001100000000000011010001
1001100111110000011111000000211001101111
1111111111111100111111100001111111111111
1111111111111111111111111111111111111111
1121111101121111011100000111001001100111
1100110200001100000000110011101112120011
1011111110000000000011111000000000100000
11001111110010000000211000X0000000000000
1110!11101000000000001000110010000002011
1101011100110000002101100000111101111111
1112111111111000011111000111111111021111
