1111111111111111111111111111111100001111
1**11**1111**11**1111**11**11100000111**
00****00**111000001100****00**001100111*
00***00***000000000000***00***1111100000
00***00000010000000000***00000*110000000
000000000000001100110S00000000**00011001
110000002111000001111100000021**10000011
11100001111111**111111100001111100011111
1100001111111100001111000011111111000011
00000111****1111001100000111****11110011
001100111****0000111001100111****0000111
1111100000*1100011111111100000*110001111
*1100000001111100000*1100000001111100000
**00011001001100111***00011001001100111*
**1000001100000111****1000001100000111**
1100011111111111111111000111111111111111
1100001111110000111111110000111111000011
00000111**00000111****11110011**11110011
001100111*001100111****0000111***0000111
11111000001111100000*110001111*110001111
*110000000*11000000011111000001111100000
**00011001**00011001001100111*001100111*
**10000011**1000001100000111**00000111**
1100011111110001111111111111111111111111
11100001110**000000011000011111100001111
1100010011000000**0000000111**00000111**
0000100000**00111000001100111*001100111*
00***00000000000000011111000001111100000
00***00***01000X0000*110000000*110000000
00****00**0000110011**00011001**00011001
1**11**1111100000111**10000011**10000011
11111111111111**111111000111111100011111
