1111111111111111111111000011111111111111
1**11**1111**11**11100000111**1**11**111
00****00**00****00**001100111*1110000011
00***00***00***00***11111000000000000000
00***0000000***00000*1100000000100000000
00000000000S00000000**000110010000110011
11000000211100000021**100000111100000111
1110000111111000011111000111111111**1111
1100001111111111111111110000111111000011
00000111**1**11**111**11110011**11110011
001100111*00****00*****0000111***0000111
111110000000***00****110001111*110001111
*11000000000***0000011111000001111100000
**000110010000000000001100111*001100111*
**10000011110000002100000111**00000111**
1100011111111000011111111111111111111111
1100001111111111111111100001111111111111
00000111**1**11**11111000100111**11**111
001100111*00****00**000010000000****00**
111110000000***00***00***0000000***00***
*11000000000***0000000***00***00***00000
**00011001000000000000****00**0000000000
**1000001111000000211**11**1111100000021
1100011111111000011111111111111110000111
11100001110**00000000**00000001111111111
1100010011000000**00000000**001**11**111
0000100000**00111000**00111000111***0011
00***0000000000000000000000000000***0000
00***00***0100000000010000000000**000000
00****00**000011001100001100110X00002011
1**11**1111100000111110000011111****1111
11111111111111**11111111**11111111**1111
