1111111111111111111111111111111111111111
1**11**11100000111**1**11**1111**11**111
00****00**001100111*00****00**00****00**
00***00***111110000000***00***00***00***
00***00000*11000000000***0000000***00000
0000000000**000110010S000000000000000000
1100000021**1000001111000000211100000021
1110000111110001111111100001111110000111
1100001111111100001111111111111110000111
00000111****111100111**11**1111100010011
001100111****000011111100000110000100000
1111100000*110001111000000000000***00000
*1100000001111100000010000000000***00***
**00011001001100111*000011001100****00**
**1000001100000111**11000001111**11**111
110001111111111111111111**11111111111111
1110000111111111111111111111111111000011
11000100111**11**1111**11**111**11110011
000010000000****00**00****00*****0000111
00***0000000***00***00***00****110001111
00***00***00***0000000***000001111100000
00****00**00000000000000000000001100111*
1**11**1111100000021110000002100000111**
1111111111111000011111100001111111111111
1111111111111000011111111111111111111111
00000111**11000100111**11**1111**11**111
001100111*0000100000111***0011111***0011
111110000000***00000000***0000000***0000
*11000000000***00***00**00000000**000000
**0001100100****00**0X000020110000002011
**100000111**11**11111****111111****1111
110001111111111111111111**11111111**1111
