1111111111111111111111111111111110000111
000001110110011@011112111211111100010011
001100111000021000!000010000000000100000
1111100000002110011100001000010001200000
!110000000001110000000000000000000100010
100001100100000000000S000000000011210000
0010000011110000002111000000211001100111
1100011111111000011111100001111111111111
1111111111111000011111111111111111111111
1021100111110001001112111001111100011000
0010000002000010000000!01100101000110000
000000001@001020000000100000111001100000
00010000000001200@1000000000001100000111
000000000000!00@001000000000001110001102
1100000021111111111111000000211100011100
1110000111111111111111100001111110001111
1100001111111111111111000011111111111111
00000111001111101111000001111!0000011100
0011001110001000000000110011110011001112
1111100000000000021011111000001111100000
2110000000000210000001100000000110000000
100001100100000000000000011001!000011001
0110000011110000002100100000112110000011
1100011111111000011111000111111100011111
1111111111110000111111000011111100001111
0000011100000001112100000111000000011110
0011001110001100111!00110011110011001112
1111100000111110000011111000001111100000
011000X000011000000001100000002110000000
1100011001000001100100000110010!00011001
2010000011011000001100100000111110000011
1100011111110001111111000111111100011111
