1111111111111111111111110000111111111111
1102111110110111011112111100111100011000
1210110001001100000210100001111000110000
1011111002001000000001100011111001100000
1121011111000110000011111000001100000111
11100111000S0000000000110011101110001100
1101011121110000002100000111011100011100
1110001111111000011111111111111110021111
1111111111111000011111100001111111111111
1011101111110001001111000100111100011000
0011110011000010000000001000001002110000
0010100000000210000000101000001101111100
0010200000000000021000201001211100011111
00000000000002100011000!0100001110101120
1100000021100111111110111001111110011111
1110000111111111111111111111111111111111
1100001111111111111111110000111111111111
0000011101000001112121111100111100111110
0011001110001100111000000001111021111010
1111100000111110000011100011111001111002
1110000000011000000011111000001112111111
0000011001010001100100110011101110011100
0110000011111000001100000111211100011101
1100011111110001111111111111111112111111
1110000111000000000011111111111110000111
1100010011000000100000000111001100010011
0000100000020011100000110011100000100000
00!0000000000000000011111000000021100000
002100002101000X000001100000000000100001
0011100000000011001101000110010011010000
10211101111100000111011000001110211@1111
111111111111111@111111000111111111111111
