0020000000111111111111111111111111111111
000000010010111001111!011001111101102111
!000111000002120001000000000!@00112000@1
0000000000000100010000211001100000000100
010000000000@000000000020000000000000000
000011001100000000000S000000000000000000
1100000111110000002111000000211100000021
1111001111111000011111100001111110000111
1111111111111111111111100001111111000011
1001100111110112111111000100111011110011
1110000011001010000000001000001100000111
0000000000001010000200021000000110001111
0100000000000100000000000000211111100000
00001100110000000000000@1!00010011001110
1100000111110000002112111101110000011122
1111001111111000011111111111111111111111
1111000011111000011111111111111111000011
0211110011110001001110011211110111110011
2000000111000010000000!01000021010000111
111000111100@100000000102000000110001111
1111100000001200021100210000001111100000
00110011100001@2000000000000000011001111
0000011121111111111111000000210000011112
1111111111111111111111100001111111111111
1111111111111111111111100001111110000111
100110!11110011@111111000100111100010011
0000210000111012001100001000000000100000
0002100100000110000000121000000000200000
00111000000002000000000120002100102000@1
00000000000X0000201100211100010000100011
1100000021110021111111011111111211110111
1110000111111100111111111111111111111111
