1111111111111111111111111111111111111111
1**11**11111***11***1**11**1111**11**111
00****00**1***11****00****00**00****00**
00***00***1**1111***00***00***00***00***
00***0000011***1111100***0000000***00000
0000000000111***11**0S000000000000000000
110000002111***111**11000000211100000021
1110000111111***111111100001111110000111
111111111111111111110**00000001110000111
1**11**1111**11**111000000**001100010011
00****00**1110000011**001110000000100000
00***00***0000000000000000000000***00000
00***000000100000000010000000000***00***
00000000000000110011000011001100****00**
1100000021110000011111000001111**11**111
11100001111111**11111111**11111111111111
1100001111111111111111111111111111000011
00000111**1**11**1111**11**111**11110011
001100111*00****00**00****00*****0000111
111110000000***00***00***00****110001111
*11000000000***0000000***000001111100000
**0001100100000000000000000000001100111*
**100000111100000021110000002100000111**
1100011111111000011111100001111111111111
1110000111111111111111000011111111111111
11000100111**11**11100000111**00000111**
00001000001110000011001100111*001100111*
00***00000000000000011111000001111100000
00***00***010000000X*110000000*110000000
00****00**0000110011**00011001**00011001
1**11**1111100000111**10000011**10000011
11111111111111**111111000111111100011111
