1111111111111111111111110000111111111111
11***11***1**11**111**111100111100011000
1***11****00****00*****00001111000110000
1**1111***00***00****1100011111001100000
11***1111100***0000011111000001100000111
111***11**0S00000000001100111*11100011**
11***111**110000002100000111**11000111**
111***111111100001111111111111111***1111
1111111111111000011111100001111111111111
1**11**1111100010011110001001111***11***
00****00**000010000000001000001***11****
00***00***00***0000000***000001**1111***
00***0000000***00***00***00***11***11111
000000000000****00**00****00**111***11**
11000000211**11**1111**11**11111***111**
111000011111111111111111111111111***1111
1100001111111111111111110000111111111111
00000111**00000111****1111001111***11***
001100111*001100111****00001111***11****
11111000001111100000*1100011111**1111***
*110000000*110000000111110000011***11111
**00011001**00011001001100111*111***11**
**10000011**1000001100000111**11***111**
110001111111000111111111111111111***1111
11100001110**000000011111111111110000111
1100010011000000**0000000111**1100010011
0000100000**00111000001100111*0000100000
00***000000000000000111110000000***00000
00***00***01000X0000*11000000000***00***
00****00**0000110011**0001100100****00**
1**11**1111100000111**100000111**11**111
11111111111111**111111000111111111111111
